Bijeg iz dvorca
An Interactive Fiction by Barbara Tatai
Release 1 / Serial number 220131 / Inform 7 build 6M62 (I6/v6.33 lib 6/12N) SD

Ime ti je Matovilka te otkako znaš za sebe zatočena si u dvorcu. Svaku večer te tvoja zla maćeha Gertruda zaključa u tvoju sobu s tvojim vjernim prijateljicama, zmajem Penelopom i mačkom Kleopatrom. Cijeli život si čekala priliku da Gertruda pogriješi, a danas si ju dočekala. Gertruda te u žurbi na novogodišnji bal zaboravila zaključati, a  znaš da se kopija ključa glavnog izlaza nalazi negdje u njezinoj sobi. Odlučila si zgrabiti ovu priliku te napokon pobjeći i biti slobodna. Imaš vremena do ponoći da pobjegneš!

Matovilkina soba
Tvoja soba nalazi se u tornju dvorca. Iznenađujuće, soba je poprilično velika te se u njoj nalazi predivan veliki krevet, ormar, violina te sve potrebno za Kleopatru i Penelopu. Ono što te podsječa na tvoje zatočeništvo su dva prozora sa željeznim rešetkama.

Južno od sobe nalazi se hodnik.

You can see Velika drvena vrata, Violina, Penelopa and Kleopatra here.

>examine vrata
Vrata tvoje sobe koja vode u hodnik.

>s
(first opening Velika drvena vrata)

Hodnik
U hodniku postoji mnogo vrata, no tebi su bitna samo ona od Gertrudine sobe.

You can see Velika drvena vrata here.

* * *

>examine Penelopa
Penelopa je manja vrsta zmaja ljubičaste boje, kao mala si ju pronašla u šumi zajedno s Kleopatrom. Penelopa je, iako godinama s tobom, vrlo mlad zmaj te ne zna još rigati vatru. Da zna, odavno bi zapalila Gertrudu!

>examine Kleopatra
Kleopatra je šarena micika koja te vjerno prati svuda. Vrlo je umiljata, osim kad vidi Gertrudu.

* * *

>n
You can't go that way.

>s
(first opening Velika drvena vrata)

Hodnik
U hodniku postoji mnogo vrata, no tebi su bitna samo ona od Gertrudine sobe.

You can see Velika drvena vrata and Vrata glavne sobe here.

* * *

>s
(first opening Velika drvena vrata)
Otvorila si vrata svoje sobe.

Hodnik
U hodniku se nalazi mnogo vrata, no tebi su bitna samo ona od Gertrudine sobe. Jedini problem je što ne znaš koja vrata vode do njezine sobe. Pročitaj natpise na vratima da saznaš! Budući da je mrak u Gertrudinoj sobi, trebala bi uzeti i lanternu! Nakon toga, trebaš proći južnim prolazom prema Dnevnoj sobi.

You can see Velika drvena vrata, Prolaz u dnevni, Vrata 1, Lanterna (in which is Svijeca) and Vrata 2 here.

>e
U glavnoj sobi je premračno! Uzmi lanternu.

Sad je 11:31 pm, još se stigneš spasiti!

>w
You can't go that way.

>take svjetiljka
Taken.

>e
Glavna soba
Glavna soba je Gertrudina soba, najveća je soba u dvorcu. U njoj se nalazi ključ glavnih vrata dvorca, pronađi ga!

You can see Vrata glavne sobe here.

* * *

>w
You can't go that way.

>n
Matovilkina soba
Tvoja soba nalazi se u tornju dvorca. Iznenađujuće, soba je poprilično velika te se u njoj nalazi predivan veliki krevet, ormar, violina te sve potrebno za Kleopatru i Penelopu. Ono što te podsječa na tvoje zatočeništvo su dva prozora sa željeznim rešetkama. Južno od sobe nalazi se hodnik.

You can see Velika drvena vrata, Penelopa and Kleopatra here.

* * *

>e
U glavnoj sobi je premračno! Uzmi lanternu.

Sad je 11:31 pm, još se stigneš spasiti!

>take svjetiljka
Taken.

>e
Glavna soba
Glavna soba je Gertrudina soba, najveća je soba u dvorcu. U njoj se nalazi kraljevski krevet, njezin omiljeni ljubimac Hrčak koji je u kavezu, ormar, noćni ormar te komoda. U njoj se također nalazi ključ glavnih vrata dvorca, pronađi ga! Zapadno se nalaze Vrata glavne sobe!

You can see Vrata glavne sobe, Komoda (closed) and Nocni ormar (closed) here.

>open vrata glavne sobe
You open Vrata glavne sobe.

>examine
(Svjetiljka)
You see nothing special about Svjetiljka.

* * *

>e
U glavnoj sobi je premračno! Uzmi lanternu.

Sad je 11:31 pm, još se stigneš spasiti!

>s
Dnevna soba
Raskošna dnevna soba s velikim kaminom u kojem gori vatra. Na stolu u kutu nalazi voće. Mogla bi si uzeti malo za put. Istočno se nalazi Prolaz prema hodniku. Sjeverno se nalaze izlazna vrata - tvoj spas!

You can see Izlazna vrata and Prolaz here.

>s
You can't go that way.

>examine Izlazna vrata
Najveća vrata koja su izlaz iz dvorca. Stara su i škripe, pazi kako ih otvaraš!

* * *

>s
Dnevna soba
Raskošna dnevna soba s velikim kaminom u kojem gori vatra. Na stolu u kutu nalazi voće. Mogla bi si uzeti malo za put. Istočno se nalazi Prolaz prema hodniku. Sjeverno se nalaze izlazna vrata - tvoj spas!

You can see Izlazna vrata and Prolaz here.

>n
(first opening Izlazna vrata)
Ne možeš izaći bez ključa! Vrati se u Gertrudinu sobu i pronađi ga!.

>e
Hodnik
U hodniku postoji mnogo vrata, no tebi su bitna samo ona od Gertrudine sobe koja se nalaze istočno od hodnika. Budući da je mrak u Gertrudinoj sobi, trebala bi uzeti svjetiljku! Nakon toga, trebaš proći južnim prolazom prema Dnevnoj sobi.

You can see Prolaz, Velika drvena vrata, Vrata glavne sobe and Svjetiljka here.

>take svjetiljka
Taken.

>e
Glavna soba
Glavna soba je Gertrudina soba, najveća je soba u dvorcu. U njoj se nalazi kraljevski krevet, njezin omiljeni ljubimac Hrčak koji je u kavezu, ormar, noćni ormar te komoda. U njoj se također nalazi ključ glavnih vrata dvorca, pronađi ga!

You can see Vrata glavne sobe, Komoda (closed) and Nocni ormar (closed) here.

>examine nocni ormar
Drveni noćni ormarić s jednom ladicom, možda je u njemu ključ!

>open komoda
You open Komoda, revealing Glavni kljuc.

>take Glavni kljuc
Taken.

>w
(first opening Vrata glavne sobe)

Hodnik
U hodniku postoji mnogo vrata, no tebi su bitna samo ona od Gertrudine sobe koja se nalaze istočno od hodnika. Budući da je mrak u Gertrudinoj sobi, trebala bi uzeti svjetiljku! Nakon toga, trebaš proći južnim prolazom prema Dnevnoj sobi.

You can see Vrata glavne sobe, Prolaz and Velika drvena vrata here.

>s
Dnevna soba
Raskošna dnevna soba s velikim kaminom u kojem gori vatra. Na stolu u kutu nalazi voće. Mogla bi si uzeti malo za put. Istočno se nalazi Prolaz prema hodniku. Sjeverno se nalaze izlazna vrata - tvoj spas!

You can see Prolaz and Izlazna vrata here.

>n
(first opening Izlazna vrata)
Ne možeš izaći bez ključa! Vrati se u Gertrudinu sobu i pronađi ga!.

* * *

>e
U glavnoj sobi je premračno! Uzmi lanternu.

Sad je 11:31 pm, još se stigneš spasiti!

>take lanterna
Uzela si lanternu. Sad možeš u Gertrudinu sobu.

Taken.

Sad je 11:32 pm, još se stigneš spasiti!

>take laterna
Taken.

>e
U glavnoj sobi je premračno! Uzmi lanternu.

* * *

>take lanterna
Uzela si lanternu. Sad možeš u Gertrudinu sobu.

Taken.

Sad je 11:32 pm, još se stigneš spasiti!

>e
(first opening Vrata glavne sobe)
Otvorila si vrata glavne sobe
Glavna soba
Glavna soba je Gertrudina soba, najveća soba u dvorcu. U njoj se nalazi kraljevski krevet, njezin omiljeni ljubimac tvor Otto koji je u kavezu, ormar, noćni ormar te komoda. U njoj se negdje također nalazi ključ glavnih vrata dvorca, pronađi ga! Zapadno se nalaze Vrata glavne sobe!

You can see Vrata glavne sobe, Penelopa, Kleopatra, Kavez (in which is Otto), Komoda (closed) and Nocni ormar (closed) here.

Sad je 11:33 pm, još se stigneš spasiti!

>open vrata glavne sobe
You open Vrata glavne sobe.

>e
You can't go that way.

>s
You can't go that way.

>w
Hodnik
U hodniku postoji mnogo vrata, no tebi su bitna samo ona od Gertrudine sobe koja se nalaze istočno od hodnika. Budući da je mrak u Gertrudinoj sobi, trebala bi uzeti lanternu! Nakon toga, trebaš proći južnim prolazom prema Dnevnoj sobi.

You can see Vrata glavne sobe, Velika drvena vrata and Prolaz here.

>open vrata glavne sobe
That's already open.

>e
Glavna soba
Glavna soba je Gertrudina soba, najveća je soba u dvorcu. U njoj se nalazi kraljevski krevet, njezin omiljeni ljubimac Hrčak koji je u kavezu, ormar, noćni ormar te komoda. U njoj se također nalazi ključ glavnih vrata dvorca, pronađi ga! Zapadno se nalaze Vrata glavne sobe!

You can see Vrata glavne sobe, Komoda (closed) and Nocni ormar (closed) here.

>penelopa
That's not a verb I recognise.

>examine penelopa
You can't see any such thing.

* * *

>e
(first opening Vrata glavne sobe)
Otvorila si vrata glavne sobe
Glavna soba
Glavna soba je Gertrudina soba, najveća soba u dvorcu. U njoj se nalazi kraljevski krevet, njezin omiljeni ljubimac tvor Otto koji je u kavezu, ormar, noćni ormar te komoda. U njoj se negdje također nalazi ključ glavnih vrata dvorca, pronađi ga! Zapadno se nalaze Vrata glavne sobe!

You can see Vrata glavne sobe, Penelopa, Kleopatra, Kavez (in which is Otto), Komoda (closed) and Nocni ormar (closed) here.

Sad je 11:33 pm, još se stigneš spasiti!

>open nocni ormar
You open Nocni ormar, revealing Dnevnik.

>examine nocni ormar
Drveni noćni ormarić s jednom ladicom, možda je u njemu ključ!

In Nocni ormar is Dnevnik.

>examine dnevnik
Običan prastari dnevnik u kojem tvoja zla maćeha vjerojatno opisuje kako muči ljude!

>take dnevnik
Taken.

>open komoda
You open Komoda, revealing Glavni kljuc.

>examine komoda
Velika drvena komoda napravljena od hrasta i stakla. Pogledaj je li u njoj negdje ključ.

In Komoda is Glavni kljuc.

>take glavni kljuc
Uzela si kljuc za izlazna vrata.

>w
Hodnik
U hodniku postoji mnogo vrata, no tebi su bitna samo ona od Gertrudine sobe koja se nalaze istočno od hodnika. Budući da je mrak u Gertrudinoj sobi, trebala bi uzeti lanternu! Nakon toga, trebaš proći južnim prolazom prema Dnevnoj sobi.

You can see Vrata glavne sobe, Velika drvena vrata and Prolaz u dnevni here.

>s
(first opening Prolaz u dnevni)

Dnevna soba
Raskošna dnevna soba s velikim kaminom u kojem gori vatra. Na stolu u kutu nalazi se hrana. Mogla bi si uzeti malo za put. Istočno se nalazi Prolaz prema hodniku. Sjeverno se nalaze izlazna vrata - tvoj spas!

You can see Izlazna vrata, Prolaz u dnevni, Penelopa and Kleopatra here.

>examine stol
Stol u kutu sobe s voćem.

In Stol is Hrana.

>examine hrana
Grožđe, sir, rajčica, masline i šipak!

>eat hrana
Ostavi hranu za put. Trebat će ti!

>take hrana
Ovo će dobro doći za put!

>inventory
You are carrying:
  Hrana
  Glavni kljuc
  Dnevnik
  Lanterna (providing light)

>examine izlazna vrata
Najveća vrata koja su izlaz iz dvorca. Stara su i škripe, pazi kako ih otvaraš!

>open izlazna vrata
Prvo otključaj vrata!

>unlock izlazna vrata with glavni kljuc
You unlock Izlazna vrata.

>e
Hodnik
U hodniku postoji mnogo vrata, no tebi su bitna samo ona od Gertrudine sobe koja se nalaze istočno od hodnika. Budući da je mrak u Gertrudinoj sobi, trebala bi uzeti lanternu! Nakon toga, trebaš proći južnim prolazom prema Dnevnoj sobi.

You can see Prolaz u dnevni, Vrata glavne sobe and Velika drvena vrata here.

>s
Dnevna soba
Raskošna dnevna soba s velikim kaminom u kojem gori vatra. Na stolu u kutu nalazi se hrana. Mogla bi si uzeti malo za put. Istočno se nalazi Prolaz prema hodniku. Sjeverno se nalaze izlazna vrata - tvoj spas!

You can see Prolaz u dnevni, Izlazna vrata, Penelopa and Kleopatra here.

>n
(first opening Izlazna vrata)
Otključala si vrata.

Otvorila si Izlazna vrata.

Dvoriste
You can see Izlazna vrata, Penelopa and Kleopatra here.

* * *

>e
(first opening Vrata glavne sobe)
Otvorila si vrata glavne sobe
Glavna soba
Glavna soba je Gertrudina soba, najveća soba u dvorcu. U njoj se nalazi kraljevski krevet, njezin omiljeni ljubimac tvor Otto koji je u kavezu, ormar, noćni ormar te komoda. U njoj se negdje također nalazi ključ glavnih vrata dvorca, pronađi ga! Zapadno se nalaze Vrata glavne sobe!

You can see Vrata glavne sobe, Penelopa, Kleopatra, Kavez (in which is Otto), Komoda (closed) and Nocni ormar (closed) here.

Sad je 11:33 pm, još se stigneš spasiti!

>examine kavez
Kavez u kojem je mali slatki hrčak. Dobro da je u kavezu jer bi ga Kleopatra inače imala za večeru!

In Kavez is Hrcak.

>take kavez
Ne možeš ga uzeti.

>examine hracak
You can't see any such thing.

>examine hrcak
Gertrudin ljubimac.

>open komoda
You open Komoda, revealing Glavni kljuc.

>take glavni kljuc
Uzela si kljuc za izlazna vrata.

>examine nocni ormar
Drveni noćni ormarić s jednom ladicom, možda je u njemu ključ!

>open nocni ormar
You open Nocni ormar, revealing Dnevnik.

>examine dnevnik
Običan prastari dnevnik u kojem tvoja zla maćeha vjerojatno opisuje kako muči ljude!

>take dnevnik
Uzela si Gertrudin dnevnik.

>w
Hodnik
U hodniku se nalaze mnogo vrata, no tebi su bitna samo ona od Gertrudine sobe koja se nalaze istočno od hodnika. Budući da je mrak u Gertrudinoj sobi, trebala bi uzeti lanternu! Nakon toga, trebaš proći južnim prolazom prema Dnevnoj sobi.

You can see Vrata glavne sobe, Velika drvena vrata and Prolaz u dnevni here.

>s
(first opening Prolaz u dnevni)

Dnevna soba
Raskošna dnevna soba s velikim kaminom u kojem gori vatra. Na stolu u kutu nalazi se hrana. Mogla bi si uzeti malo za put. Istočno se nalazi Prolaz prema hodniku. Sjeverno se nalaze izlazna vrata - tvoj spas!

On Stol is Hrana.

You can also see Izlazna vrata, Prolaz u dnevni, Penelopa and Kleopatra here.

>examine vatra
Čuje se pucketanje vatre u kaminu.

>examine kamin
Kamin is empty.

>open izlazna vrata
Prvo otključaj vrata! Ako nemaš ključ, vrati se u Gertrudinu sobu.

>inventory
You are carrying:
  Dnevnik
  Glavni kljuc
  Lanterna (providing light)

>examine hrana
Grožđe, sir, rajčica, masline i šipak!

>examine stol
Stol u kutu sobe s voćem.

On Stol is Hrana.

>take hrana
Ovo će dobro doći za put!

>eat hrana
Ostavi hranu za put. Trebat će ti!

>ask penelopa about hrana
Mislim da bi trebali ponijeti nešto za pojest

>ask penelopa about vrijeme
9:24 pm

>ask penelopa about bijeg
Mislim da bolju šansu nećemo imati!

>unlock izlazna vrata
What do you want to unlock Izlazna vrata with?

>glavni kljuc
You unlock Izlazna vrata.

>s
You can't go that way.

>n
(first opening Izlazna vrata)
Otključala si vrata.

Otvorila si Izlazna vrata.

    *** You have won! ***

Would you like to RESTART, RESTORE a saved game, QUIT or UNDO the last command?

* * *

>e
(first opening Vrata glavne sobe)
Otvorila si vrata glavne sobe
Glavna soba
Glavna soba je Gertrudina soba, najveća soba u dvorcu. U njoj se nalazi kraljevski krevet, njezin omiljeni ljubimac tvor Otto koji je u kavezu, ormar, noćni ormar te komoda. U njoj se negdje također nalazi ključ glavnih vrata dvorca, pronađi ga! Zapadno se nalaze Vrata glavne sobe!

You can see Vrata glavne sobe, Penelopa, Kleopatra, Kavez (in which is Otto), Komoda (closed) and Nocni ormar (closed) here.

Sad je 11:33 pm, još se stigneš spasiti!

>examine komoda
Velika drvena komoda napravljena od hrasta i stakla. Pogledaj je li u njoj negdje ključ.

Sad je 11:34 pm, još se stigneš spasiti!

>open komoda
You open Komoda, revealing Glavni kljuc.

Sad je 11:35 pm, još se stigneš spasiti!

>examine komoda
Vidi, u njoj se nalazi glavni kljuc!

In Komoda is Glavni kljuc.

Sad je 11:36 pm, još se stigneš spasiti!

>examine komoda
Vidi, u njoj se nalazi glavni kljuc!

In Komoda is Glavni kljuc.

Sad je 11:37 pm, još se stigneš spasiti!

>take glavni kljuc
Uzela si kljuc za izlazna vrata.

Taken.

Sad je 11:38 pm, još se stigneš spasiti!

>w
Hodnik
U hodniku se nalazi mnogo vrata, no tebi su bitna samo ona od Gertrudine sobe koja se nalaze istočno od hodnika. Budući da je mrak u Gertrudinoj sobi, trebala bi uzeti lanternu! Nakon toga, trebaš proći južnim prolazom prema Dnevnoj sobi.

You can see Vrata glavne sobe, Velika drvena vrata and Prolaz u dnevni here.

Sad je 11:39 pm, još se stigneš spasiti!

>s
(first opening Prolaz u dnevni)

Dnevna soba
Raskošna dnevna soba s velikim kaminom u kojem gori vatra. Na stolu u kutu nalazi se hrana. Mogla bi si uzeti malo za put. Sjeverno se nalazi Prolaz prema hodniku. Zapadno se nalaze izlazna vrata - tvoj spas!

On Stol is Hrana.

You can also see Izlazna vrata, Prolaz u dnevni, Penelopa and Kleopatra here.

Sad je 11:40 pm, još se stigneš spasiti!

>unlock izlazna vrata
What do you want to unlock Izlazna vrata with?

>glavni kljuc
You unlock Izlazna vrata.

Sad je 11:41 pm, još se stigneš spasiti!

>w
(first opening Izlazna vrata)
Otvorila si Izlazna vrata.

Dvoriste
Lia je ovdje, veliki njemački ovčar koji čuva dvorac noću. Moram ju pomaziti da me pusti.

You can also see Izlazna vrata, Penelopa and Kleopatra here.

Sad je 11:42 pm, još se stigneš spasiti!

>pomazi Lia
*** Čestitam, uspjela si se spasiti! Odletjela si na Penelopi. ***

Would you like to RESTART, RESTORE a saved game, QUIT or UNDO the last command?

* * *

>s
(first opening Velika drvena vrata)
Otvorila si vrata svoje sobe.

Hodnik
U hodniku se nalazi mnogo vrata, no tebi su bitna samo ona od Gertrudine sobe. Jedini problem je što ne znaš koja vrata vode do njezine sobe. Pročitaj natpise na vratima da saznaš! Budući da je mrak u Gertrudinoj sobi, trebala bi uzeti i lanternu! Nakon toga, trebaš proći južnim prolazom prema Dnevnoj sobi.

You can see Velika drvena vrata, Prolaz u dnevni, Vrata 1, Lanterna (in which is Svijeca) and Vrata 2 here.

>take svjetiljka
Taken.

* * *

>e
Glavna soba
Glavna soba je Gertrudina soba, najveća je soba u dvorcu. U njoj se nalazi kraljevski krevet, njezin omiljeni ljubimac Hrčak koji je u kavezu, ormar, noćni ormar te komoda. U njoj se također nalazi ključ glavnih vrata dvorca, pronađi ga! Zapadno se nalaze Vrata glavne sobe!

You can see Vrata glavne sobe, Komoda (closed) and Nocni ormar (closed) here.

>examine krevet
You can't see any such thing.

* * *

>e
Glavna soba
Glavna soba je Gertrudina soba, najveća je soba u dvorcu. U njoj se nalazi kraljevski krevet, njezin omiljeni ljubimac Hrčak koji je u kavezu, ormar, noćni ormar te komoda. U njoj se također nalazi ključ glavnih vrata dvorca, pronađi ga! Zapadno se nalaze Vrata glavne sobe!

You can see Vrata glavne sobe, Komoda (closed) and Nocni ormar (closed) here.

>open komoda
You open Komoda, revealing Glavni kljuc.

>take glavni kljuc
Taken.

>inventory
You are carrying:
  Glavni kljuc
  Svjetiljka (providing light)

>w
(first opening Vrata glavne sobe)

Hodnik
U hodniku postoji mnogo vrata, no tebi su bitna samo ona od Gertrudine sobe koja se nalaze istočno od hodnika. Budući da je mrak u Gertrudinoj sobi, trebala bi uzeti svjetiljku! Nakon toga, trebaš proći južnim prolazom prema Dnevnoj sobi.

You can see Vrata glavne sobe, Velika drvena vrata and Prolaz here.

>s
Dnevna soba
Raskošna dnevna soba s velikim kaminom u kojem gori vatra. Na stolu u kutu nalazi voće. Mogla bi si uzeti malo za put. Istočno se nalazi Prolaz prema hodniku. Sjeverno se nalaze izlazna vrata - tvoj spas!

You can see Izlazna vrata and Prolaz here.

>examine izlazna vrata
Najveća vrata koja su izlaz iz dvorca. Stara su i škripe, pazi kako ih otvaraš!

>open izlazna vrata
Ne možeš izaći bez ključa! Vrati se u Gertrudinu sobu i pronađi ga!.

>unlock izlazna vrata
What do you want to unlock Izlazna vrata with?

* * *

>take glavni kljuc
Taken.

>w
(first opening Vrata glavne sobe)

Hodnik
U hodniku postoji mnogo vrata, no tebi su bitna samo ona od Gertrudine sobe koja se nalaze istočno od hodnika. Budući da je mrak u Gertrudinoj sobi, trebala bi uzeti svjetiljku! Nakon toga, trebaš proći južnim prolazom prema Dnevnoj sobi.

You can see Vrata glavne sobe, Velika drvena vrata and Prolaz here.

>e
Glavna soba
Glavna soba je Gertrudina soba, najveća je soba u dvorcu. U njoj se nalazi kraljevski krevet, njezin omiljeni ljubimac Hrčak koji je u kavezu, ormar, noćni ormar te komoda. U njoj se također nalazi ključ glavnih vrata dvorca, pronađi ga! Zapadno se nalaze Vrata glavne sobe!

You can see Vrata glavne sobe, Penelopa, Kleopatra, Komoda (empty) and Nocni ormar (closed) here.

>w
Hodnik
U hodniku postoji mnogo vrata, no tebi su bitna samo ona od Gertrudine sobe koja se nalaze istočno od hodnika. Budući da je mrak u Gertrudinoj sobi, trebala bi uzeti svjetiljku! Nakon toga, trebaš proći južnim prolazom prema Dnevnoj sobi.

You can see Vrata glavne sobe, Velika drvena vrata and Prolaz here.

>s
Dnevna soba
Raskošna dnevna soba s velikim kaminom u kojem gori vatra. Na stolu u kutu nalazi voće. Mogla bi si uzeti malo za put. Istočno se nalazi Prolaz prema hodniku. Sjeverno se nalaze izlazna vrata - tvoj spas!

You can see Izlazna vrata and Prolaz here.

* * *

>s
You can't go that way.

>open izlazna vrata
It seems to be locked.

>unlock izlazna vrata
What do you want to unlock Izlazna vrata with?

* * *

>glavni kljuc
You unlock Izlazna vrata.

>open izlazna vrata
You open Izlazna vrata.

>s
You can't go that way.

>n
Dvoriste
You can see Izlazna vrata here.

* * *

>e
Glavna soba
Glavna soba je Gertrudina soba, najveća je soba u dvorcu. U njoj se nalazi kraljevski krevet, njezin omiljeni ljubimac Hrčak koji je u kavezu, ormar, noćni ormar te komoda. U njoj se također nalazi ključ glavnih vrata dvorca, pronađi ga!

You can see Vrata glavne sobe, Komoda (closed) and Nocni ormar (closed) here.

>examine hrčak
You can't see any such thing.

>examine krevet
You see nothing special about Krevet.

>examine kavez
In Kavez is Hr ak.

>examine hrčak
You can't see any such thing.

* * *

>s
(first opening Velika drvena vrata)
Otvorila si vrata svoje sobe.

Hodnik
U hodniku se nalazi mnogo vrata, no tebi su bitna samo ona od Gertrudine sobe. Jedini problem je što ne znaš koja vrata vode do njezine sobe. Pročitaj natpise na vratima da saznaš! Budući da je mrak u Gertrudinoj sobi, trebala bi uzeti i lanternu! Nakon toga, trebaš proći južnim prolazom prema Dnevnoj sobi.

You can see Velika drvena vrata, Prolaz u dnevni, Vrata 1, Lanterna (in which is Svijeca) and Vrata 2 here.

>s
(first opening Prolaz u dnevni)

Dnevna soba
Raskošna dnevna soba s velikim kaminom u kojem gori vatra. Na stolu u kutu nalazi se hrana. Mogla bi si uzeti malo za put. Sjeverno se nalazi Prolaz prema hodniku. Zapadno se nalaze izlazna vrata - tvoj spas!

On Stol is Hrana.

You can also see Izlazna vrata, Prolaz u dnevni, Penelopa and Kleopatra here.

Sad je 11:31 pm, još se stigneš spasiti!

>s
You can't go that way.

Sad je 11:32 pm, još se stigneš spasiti!

>n
(first opening Izlazna vrata)
Ne možeš izaći bez ključa! Vrati se u Gertrudinu sobu i pronađi ga!.

>look
Dnevna soba
You can see Izlazna vrata and Prolaz here.

* * *

>s
(first opening Prolaz u dnevni)

Dnevna soba
Raskošna dnevna soba s velikim kaminom u kojem gori vatra. Na stolu u kutu nalazi se hrana. Mogla bi si uzeti malo za put. Sjeverno se nalazi Prolaz prema hodniku. Zapadno se nalaze izlazna vrata - tvoj spas!

On Stol is Hrana.

You can also see Izlazna vrata, Prolaz u dnevni, Penelopa and Kleopatra here.

Sad je 11:31 pm, još se stigneš spasiti!

>e
Hodnik
U hodniku postoji mnogo vrata, no tebi su bitna samo ona od Gertrudine sobe koja se nalaze istočno od hodnika. Budući da je mrak u Gertrudinoj sobi, trebala bi uzeti svjetiljku! Nakon toga, trebaš proći južnim prolazom prema Dnevnoj sobi.

You can see Prolaz, Velika drvena vrata, Vrata glavne sobe and Svjetiljka here.

* * *

>s
(first opening Prolaz u dnevni)

Dnevna soba
Raskošna dnevna soba s velikim kaminom u kojem gori vatra. Na stolu u kutu nalazi se hrana. Mogla bi si uzeti malo za put. Sjeverno se nalazi Prolaz prema hodniku. Zapadno se nalaze izlazna vrata - tvoj spas!

On Stol is Hrana.

You can also see Izlazna vrata, Prolaz u dnevni, Penelopa and Kleopatra here.

Sad je 11:31 pm, još se stigneš spasiti!

>eat hrana
Ostavi hranu za put. Trebat će ti!

>pojedi hrana
I only understood you as far as wanting to pojedi.

* * *

>n
(first opening Izlazna vrata)
It seems to be locked.

* * *

>s
(first opening Prolaz u dnevni)

Dnevna soba
Raskošna dnevna soba s velikim kaminom u kojem gori vatra. Na stolu u kutu nalazi se hrana. Mogla bi si uzeti malo za put. Sjeverno se nalazi Prolaz prema hodniku. Zapadno se nalaze izlazna vrata - tvoj spas!

On Stol is Hrana.

You can also see Izlazna vrata, Prolaz u dnevni, Penelopa and Kleopatra here.

Sad je 11:31 pm, još se stigneš spasiti!

>n
Hodnik
U hodniku se nalazi mnogo vrata, no tebi su bitna samo ona od Gertrudine sobe koja se nalaze istočno od hodnika. Budući da je mrak u Gertrudinoj sobi, trebala bi uzeti lanternu! Nakon toga, trebaš proći južnim prolazom prema Dnevnoj sobi.

You can see Prolaz u dnevni, Velika drvena vrata, Vrata glavne sobe and Lanterna here.

Sad je 11:32 pm, još se stigneš spasiti!

>e
U glavnoj sobi je premračno! Uzmi lanternu.

Sad je 11:33 pm, još se stigneš spasiti!

>take lanterna
Uzela si lanternu. Sad možeš u Gertrudinu sobu.

Taken.

Sad je 11:34 pm, još se stigneš spasiti!

>e
(first opening Vrata glavne sobe)
Otvorila si vrata glavne sobe
Glavna soba
Glavna soba je Gertrudina soba, najveća soba u dvorcu. U njoj se nalazi kraljevski krevet, njezin omiljeni ljubimac tvor Otto koji je u kavezu, ormar, noćni ormar te komoda. U njoj se negdje također nalazi ključ glavnih vrata dvorca, pronađi ga! Zapadno se nalaze Vrata glavne sobe!

You can see Vrata glavne sobe, Penelopa, Kleopatra, Kavez (in which is Otto), Komoda (closed) and Nocni ormar (closed) here.

Sad je 11:35 pm, još se stigneš spasiti!

>open komoda
You open Komoda, revealing Glavni kljuc.

Sad je 11:36 pm, još se stigneš spasiti!

>take glavni kljuc
Uzela si kljuc za izlazna vrata.

Taken.

Sad je 11:37 pm, još se stigneš spasiti!

>w
Hodnik
U hodniku se nalazi mnogo vrata, no tebi su bitna samo ona od Gertrudine sobe koja se nalaze istočno od hodnika. Budući da je mrak u Gertrudinoj sobi, trebala bi uzeti lanternu! Nakon toga, trebaš proći južnim prolazom prema Dnevnoj sobi.

You can see Vrata glavne sobe, Prolaz u dnevni and Velika drvena vrata here.

Sad je 11:38 pm, još se stigneš spasiti!

>s
Dnevna soba
Raskošna dnevna soba s velikim kaminom u kojem gori vatra. Na stolu u kutu nalazi se hrana. Mogla bi si uzeti malo za put. Sjeverno se nalazi Prolaz prema hodniku. Zapadno se nalaze izlazna vrata - tvoj spas!

On Stol is Hrana.

You can also see Prolaz u dnevni and Izlazna vrata here.

Sad je 11:39 pm, još se stigneš spasiti!

>unlock izlazna vrata with glavni kljuc
You unlock Izlazna vrata.

Sad je 11:40 pm, još se stigneš spasiti!

>w
(first opening Izlazna vrata)
Otvorila si Izlazna vrata.

Dvoriste
Lia je ovdje, veliki njemački ovčar koji čuva dvorac noću. Moram ju pomaziti da me pusti.

You can also see Izlazna vrata, Penelopa and Kleopatra here.

Sad je 11:41 pm, još se stigneš spasiti!

>pomazi vrata
Liu trebaš pomaziti da te pusti.

Sad je 11:42 pm, još se stigneš spasiti!

>pomazi penelopa
Liu trebaš pomaziti da te pusti.

Sad je 11:43 pm, još se stigneš spasiti!

>pomazi Lia
*** Čestitam, uspjela si se spasiti! Možeš odletjeti na Penelopi. ***

Would you like to RESTART, RESTORE a saved game, QUIT or UNDO the last command?

* * *

>s
(first opening Velika drvena vrata)
Otvorila si vrata svoje sobe.

Hodnik
U hodniku se nalazi mnogo vrata, no tebi su bitna samo ona od Gertrudine sobe. Jedini problem je što ne znaš koja vrata vode do njezine sobe. Pročitaj natpise na vratima da saznaš! Budući da je mrak u Gertrudinoj sobi, trebala bi uzeti i lanternu! Nakon toga, trebaš proći južnim prolazom prema Dnevnoj sobi.

You can see Velika drvena vrata, Prolaz u dnevni, Vrata 1, Lanterna (in which is Svijeca) and Vrata 2 here.

>take lanterna
Taken.

>e
(first opening Vrata glavne sobe)
Otvorila si vrata glavne sobe
Glavna soba
Glavna soba je Gertrudina soba, najveća soba u dvorcu. U njoj se nalazi kraljevski krevet, njezin omiljeni ljubimac tvor Otto koji je u kavezu, ormar, noćni ormar te komoda. U njoj se negdje također nalazi ključ glavnih vrata dvorca, pronađi ga! Zapadno se nalaze Vrata glavne sobe!

You can see Vrata glavne sobe, Penelopa, Kleopatra, Kavez (in which is Otto), Komoda (closed) and Nocni ormar (closed) here.

Sad je 11:32 pm, još se stigneš spasiti!

>w
Hodnik
U hodniku se nalazi mnogo vrata, no tebi su bitna samo ona od Gertrudine sobe koja se nalaze istočno od hodnika. Budući da je mrak u Gertrudinoj sobi, trebala bi uzeti lanternu! Nakon toga, trebaš proći južnim prolazom prema Dnevnoj sobi.

You can see Vrata glavne sobe, Velika drvena vrata and Prolaz u dnevni here.

>s
(first opening Prolaz u dnevni)

Dnevna soba
Raskošna dnevna soba s velikim kaminom u kojem gori vatra. Na stolu u kutu nalazi se hrana. Mogla bi si uzeti malo za put. Sjeverno se nalazi Prolaz prema hodniku. Zapadno se nalaze izlazna vrata - tvoj spas!

On Stol is Hrana.

You can also see Izlazna vrata, Prolaz u dnevni, Penelopa and Kleopatra here.

>take hrana
Ovo će dobro doći za put!

>eat hrana
Ovo je vrlo ukusno. Ali moramo ostavit i za put!

>examine
(Lanterna)
Mala tamno zelena lanterna.

* * *

>s
(first opening Prolaz u dnevni)

Dnevna soba
Raskošna dnevna soba s velikim kaminom u kojem gori vatra. Na stolu u kutu nalazi se hrana. Mogla bi si uzeti malo za put. Sjeverno se nalazi Prolaz prema hodniku. Zapadno se nalaze izlazna vrata - tvoj spas!

On Stol is Hrana.

You can also see Izlazna vrata, Prolaz u dnevni, Penelopa and Kleopatra here.

>n
Hodnik
U hodniku se nalazi mnogo vrata, no tebi su bitna samo ona od Gertrudine sobe koja se nalaze istočno od hodnika. Budući da je mrak u Gertrudinoj sobi, trebala bi uzeti lanternu! Nakon toga, trebaš proći južnim prolazom prema Dnevnoj sobi.

You can see Prolaz u dnevni, Vrata glavne sobe and Velika drvena vrata here.

>s
Dnevna soba
Raskošna dnevna soba s velikim kaminom u kojem gori vatra. Na stolu u kutu nalazi se hrana. Mogla bi si uzeti malo za put. Sjeverno se nalazi Prolaz prema hodniku. Zapadno se nalaze izlazna vrata - tvoj spas!

On Stol is Hrana.

You can also see Prolaz u dnevni, Izlazna vrata, Penelopa and Kleopatra here.

>w
(first opening Izlazna vrata)
Prvo otključaj vrata! Ako nemaš ključ, vrati se u Gertrudinu sobu.

>unlock izlazna vrata
(with Lanterna)
That doesn't seem to fit the lock.

>s
You can't go that way.

>n
Hodnik
U hodniku se nalazi mnogo vrata, no tebi su bitna samo ona od Gertrudine sobe koja se nalaze istočno od hodnika. Budući da je mrak u Gertrudinoj sobi, trebala bi uzeti lanternu! Nakon toga, trebaš proći južnim prolazom prema Dnevnoj sobi.

You can see Prolaz u dnevni, Vrata glavne sobe and Velika drvena vrata here.

>e
Glavna soba
Glavna soba je Gertrudina soba, najveća soba u dvorcu. U njoj se nalazi kraljevski krevet, njezin omiljeni ljubimac tvor Otto koji je u kavezu, ormar, noćni ormar te komoda. U njoj se negdje također nalazi ključ glavnih vrata dvorca, pronađi ga! Zapadno se nalaze Vrata glavne sobe!

You can see Vrata glavne sobe, Kavez (in which is Otto), Komoda (closed) and Nocni ormar (closed) here.

>open nocni ormar
You open Nocni ormar, revealing Dnevnik.

>open komoda
You open Komoda, revealing Glavni kljuc.

>take glavni kljuc
Uzela si kljuc za izlazna vrata.

Taken.

>w
Hodnik
U hodniku se nalazi mnogo vrata, no tebi su bitna samo ona od Gertrudine sobe koja se nalaze istočno od hodnika. Budući da je mrak u Gertrudinoj sobi, trebala bi uzeti lanternu! Nakon toga, trebaš proći južnim prolazom prema Dnevnoj sobi.

You can see Vrata glavne sobe, Prolaz u dnevni and Velika drvena vrata here.

>s
Dnevna soba
Raskošna dnevna soba s velikim kaminom u kojem gori vatra. Na stolu u kutu nalazi se hrana. Mogla bi si uzeti malo za put. Sjeverno se nalazi Prolaz prema hodniku. Zapadno se nalaze izlazna vrata - tvoj spas!

On Stol is Hrana.

You can also see Prolaz u dnevni, Izlazna vrata, Penelopa and Kleopatra here.

>take hrana
Ovo će dobro doći za put!

* * *

>ask penelopa about hrana
Mislim da bi trebali ponijeti nešto za pojest

>ask penelopa about bijeg
Mislim da bolju šansu nećemo imati!

>ask penelopa about vrijeme
Sada je 9:21 pm

>w
(first opening Izlazna vrata)
Prvo otključaj vrata! Ako nemaš ključ, vrati se u Gertrudinu sobu.

>unlock izlazna vrata
What do you want to unlock Izlazna vrata with?

* * *

>glavni kljuc
You unlock Izlazna vrata.

>w
(first opening Izlazna vrata)
Otključala si vrata.

Otvorila si Izlazna vrata.

    *** Čestitam, uspjela si se spasiti! Možeš odletjeti na Penelopi. ***

Would you like to RESTART, RESTORE a saved game, QUIT or UNDO the last command?

* * *

>w
Hodnik
U hodniku se nalazi mnogo vrata, no tebi su bitna samo ona od Gertrudine sobe koja se nalaze istočno od hodnika. Budući da je mrak u Gertrudinoj sobi, trebala bi uzeti lanternu! Nakon toga, trebaš proći južnim prolazom prema Dnevnoj sobi.

You can see Vrata glavne sobe, Velika drvena vrata and Prolaz u dnevni here.

>e
Glavna soba
Glavna soba je Gertrudina soba, najveća je soba u dvorcu. U njoj se nalazi kraljevski krevet, njezin omiljeni ljubimac Hrčak koji je u kavezu, ormar, noćni ormar te komoda. U njoj se također nalazi ključ glavnih vrata dvorca, pronađi ga! Zapadno se nalaze Vrata glavne sobe!

You can see Vrata glavne sobe, Penelopa, Kleopatra, Komoda (closed) and Nocni ormar (closed) here.

>w
Hodnik
U hodniku postoji mnogo vrata, no tebi su bitna samo ona od Gertrudine sobe koja se nalaze istočno od hodnika. Budući da je mrak u Gertrudinoj sobi, trebala bi uzeti lanternu! Nakon toga, trebaš proći južnim prolazom prema Dnevnoj sobi.

You can see Vrata glavne sobe, Velika drvena vrata and Prolaz here.

>s
Dnevna soba
Raskošna dnevna soba s velikim kaminom u kojem gori vatra. Na stolu u kutu nalazi se hrana. Mogla bi si uzeti malo za put. Istočno se nalazi Prolaz prema hodniku. Sjeverno se nalaze izlazna vrata - tvoj spas!

On Stol is Hrana.

You can also see Izlazna vrata and Prolaz here.

* * *

>e
(first opening Vrata glavne sobe)
Otvorila si vrata glavne sobe
Glavna soba
Glavna soba je Gertrudina soba, najveća soba u dvorcu. U njoj se nalazi kraljevski krevet, njezin omiljeni ljubimac tvor Otto koji je u kavezu, ormar, noćni ormar te komoda. U njoj se negdje također nalazi ključ glavnih vrata dvorca, pronađi ga! Zapadno se nalaze Vrata glavne sobe!

You can see Vrata glavne sobe, Penelopa, Kleopatra, Kavez (in which is Otto), Komoda (closed) and Nocni ormar (closed) here.

Sad je 11:32 pm, još se stigneš spasiti!

>take kavez
That's fixed in place.

* * *

>e
(first opening Vrata glavne sobe)
Otvorila si vrata glavne sobe
Glavna soba
Glavna soba je Gertrudina soba, najveća soba u dvorcu. U njoj se nalazi kraljevski krevet, njezin omiljeni ljubimac tvor Otto koji je u kavezu, ormar, noćni ormar te komoda. U njoj se negdje također nalazi ključ glavnih vrata dvorca, pronađi ga! Zapadno se nalaze Vrata glavne sobe!

You can see Vrata glavne sobe, Penelopa, Kleopatra, Kavez (in which is Otto), Komoda (closed) and Nocni ormar (closed) here.

Sad je 11:32 pm, još se stigneš spasiti!

>e
(first opening Vrata glavne sobe)

Glavna soba
Glavna soba je Gertrudina soba, najveća soba u dvorcu. U njoj se nalazi kraljevski krevet, njezin omiljeni ljubimac tvor Otto koji je u kavezu, ormar, noćni ormar te komoda. U njoj se negdje također nalazi ključ glavnih vrata dvorca, pronađi ga! Zapadno se nalaze Vrata glavne sobe!

You can see Vrata glavne sobe, Penelopa, Kleopatra, Kavez (in which is Otto), Komoda (closed) and Nocni ormar (closed) here.

>w
Hodnik
U hodniku se nalazi mnogo vrata, no tebi su bitna samo ona od Gertrudine sobe koja se nalaze istočno od hodnika. Budući da je mrak u Gertrudinoj sobi, trebala bi uzeti lanternu! Nakon toga, trebaš proći južnim prolazom prema Dnevnoj sobi.

You can see Vrata glavne sobe, Velika drvena vrata and Prolaz u dnevni here.

* * *

>e
(first opening Vrata glavne sobe)
Otvorila si vrata glavne sobe
Glavna soba
Glavna soba je Gertrudina soba, najveća soba u dvorcu. U njoj se nalazi kraljevski krevet, njezin omiljeni ljubimac tvor Otto koji je u kavezu, ormar, noćni ormar te komoda. U njoj se negdje također nalazi ključ glavnih vrata dvorca, pronađi ga! Zapadno se nalaze Vrata glavne sobe!

You can see Vrata glavne sobe, Penelopa, Kleopatra, Kavez (in which is Otto), Komoda (closed) and Nocni ormar (closed) here.

Sad je 11:32 pm, još se stigneš spasiti!

>open komoda
You open Komoda, revealing Glavni kljuc.

Sad je 11:33 pm, još se stigneš spasiti!

>take glavni kljuc
Uzela si kljuc za izlazna vrata.

Taken.

Sad je 11:34 pm, još se stigneš spasiti!

>w
Hodnik
U hodniku se nalazi mnogo vrata, no tebi su bitna samo ona od Gertrudine sobe koja se nalaze istočno od hodnika. Budući da je mrak u Gertrudinoj sobi, trebala bi uzeti lanternu! Nakon toga, trebaš proći južnim prolazom prema Dnevnoj sobi.

You can see Vrata glavne sobe, Velika drvena vrata and Prolaz u dnevni here.

Sad je 11:35 pm, još se stigneš spasiti!

>s
(first opening Prolaz u dnevni)

Dnevna soba
Raskošna dnevna soba s velikim kaminom u kojem gori vatra. Na stolu u kutu nalazi se hrana. Mogla bi si uzeti malo za put. Sjeverno se nalazi Prolaz prema hodniku. Zapadno se nalaze izlazna vrata - tvoj spas!

On Stol is Hrana.

You can also see Izlazna vrata, Prolaz u dnevni, Penelopa and Kleopatra here.

Sad je 11:36 pm, još se stigneš spasiti!

>open izlazna vrata
Prvo otključaj vrata! Ako nemaš ključ, vrati se u Gertrudinu sobu.

>unlock vrata
What do you want to unlock Izlazna vrata with?

>glavni kljuc
You unlock Izlazna vrata.

>open izlazna vrata
Otvorila si Izlazna vrata.

You open Izlazna vrata.

>w
*** Čestitam, uspjela si se spasiti! Možeš odletjeti na Penelopi. ***

Would you like to RESTART, RESTORE a saved game, QUIT or UNDO the last command?

* * *

>s
(first opening Prolaz u dnevni)

Dnevna soba
Raskošna dnevna soba s velikim kaminom u kojem gori vatra. Na stolu u kutu nalazi se hrana. Mogla bi si uzeti malo za put. Sjeverno se nalazi Prolaz prema hodniku. Zapadno se nalaze izlazna vrata - tvoj spas!

On Stol is Hrana.

You can also see Izlazna vrata, Prolaz u dnevni, Penelopa and Kleopatra here.

Sad je 11:36 pm, još se stigneš spasiti!

>unlock izlazna vrata
What do you want to unlock Izlazna vrata with?

>glavni kljuc
You unlock Izlazna vrata.

Sad je 11:37 pm, još se stigneš spasiti!

>open izlazna vrata
Otvorila si Izlazna vrata.

You open Izlazna vrata.

Sad je 11:38 pm, još se stigneš spasiti!

>w
Dvoriste
Lia je ovdje, veliki njemački ovčar koji čuva dvorac noću. Moram ju pomaziti da me pusti.

You can also see Izlazna vrata, Penelopa and Kleopatra here.

Sad je 11:39 pm, još se stigneš spasiti!

>pomazi Lia
*** Čestitam, uspjela si se spasiti! Odletjela si na Penelopi. ***

Would you like to RESTART, RESTORE a saved game, QUIT or UNDO the last command?

>RESTART
Bijeg iz dvorca
An Interactive Fiction by Barbara Tatai
Release 1 / Serial number 220125 / Inform 7 build 6M62 (I6/v6.33 lib 6/12N) SD

Ime ti je Matovilka te otkako znaš za sebe zatočena si u dvorcu. Svaku večer te tvoja zla maćeha Gertruda zaključa u tvoju sobu s tvojim vjernim prijateljicama, zmajem Penelopom i mačkom Kleopatrom. Cijeli život si čekala priliku da Gertruda pogriješi, a danas si ju dočekala. Gertruda te u žurbi na novogodišnji bal zaboravila zaključati, a  znaš da se kopija ključa glavnog izlaza nalazi negdje u njezinoj sobi. Odlučila si zgrabiti ovu priliku te napokon pobjeći i biti slobodna. Imaš vremena do ponoći da pobjegneš!

Matovilkina soba
Tvoja soba nalazi se u tornju dvorca. Iznenađujuće, soba je poprilično velika te se u njoj nalazi predivan veliki krevet, ormar, violina te sve potrebno za Kleopatru i Penelopu. Ono što te podsječa na tvoje zatočeništvo su dva prozora sa željeznim rešetkama.

Južno od sobe nalazi se hodnik.

You can see Velika drvena vrata, Violina, Penelopa and Kleopatra here.

* * *

>take glavni kljuc
Uzela si kljuc za izlazna vrata.

Taken.

Sad je 11:34 pm, još se stigneš spasiti!

>e
You can't go that way.

Sad je 11:35 pm, još se stigneš spasiti!

>w
Hodnik
U hodniku se nalazi mnogo vrata, no tebi su bitna samo ona od Gertrudine sobe koja se nalaze istočno od hodnika. Budući da je mrak u Gertrudinoj sobi, trebala bi uzeti lanternu! Nakon toga, trebaš proći južnim prolazom prema Dnevnoj sobi.

You can see Vrata glavne sobe, Velika drvena vrata and Prolaz u dnevni here.

Sad je 11:36 pm, još se stigneš spasiti!

>s
(first opening Prolaz u dnevni)

Dnevna soba
Raskošna dnevna soba s velikim kaminom u kojem gori vatra. Na stolu u kutu nalazi se hrana. Mogla bi si uzeti malo za put. Sjeverno se nalazi Prolaz prema hodniku. Zapadno se nalaze izlazna vrata - tvoj spas!

On Stol is Hrana.

You can also see Izlazna vrata, Prolaz u dnevni, Penelopa and Kleopatra here.

Sad je 11:37 pm, još se stigneš spasiti!

>unlock izlazna vrata
What do you want to unlock Izlazna vrata with?

>Glavni kljuc
You unlock Izlazna vrata.

Sad je 11:38 pm, još se stigneš spasiti!

>insert glavni kljuc into izlazna vrata
That can't contain things.

Sad je 11:39 pm, još se stigneš spasiti!

* * *

>open komoda
You open Komoda, revealing Glavni kljuc.

Sad je 11:33 pm, još se stigneš spasiti!

>open nocni ormar
You open Nocni ormar, revealing Dnevnik.

Sad je 11:34 pm, još se stigneš spasiti!

>w
Hodnik
U hodniku se nalazi mnogo vrata, no tebi su bitna samo ona od Gertrudine sobe koja se nalaze istočno od hodnika. Budući da je mrak u Gertrudinoj sobi, trebala bi uzeti lanternu! Nakon toga, trebaš proći južnim prolazom prema Dnevnoj sobi.

You can see Vrata glavne sobe, Velika drvena vrata and Prolaz u dnevni here.

Sad je 11:35 pm, još se stigneš spasiti!

>e
Glavna soba
Glavna soba je Gertrudina soba, najveća soba u dvorcu. U njoj se nalazi kraljevski krevet, njezin omiljeni ljubimac tvor Otto koji je u kavezu, ormar, noćni ormar te komoda. U njoj se negdje također nalazi ključ glavnih vrata dvorca, pronađi ga! Zapadno se nalaze Vrata glavne sobe!

You can see Vrata glavne sobe, Penelopa, Kleopatra, Kavez (in which is Otto), Komoda (in which is Glavni kljuc) and Nocni ormar (in which is Dnevnik) here.

Sad je 11:36 pm, još se stigneš spasiti!

>take glavni kljuc
Uzela si kljuc za izlazna vrata.

Taken.

Sad je 11:37 pm, još se stigneš spasiti!

>w
Hodnik
U hodniku se nalazi mnogo vrata, no tebi su bitna samo ona od Gertrudine sobe koja se nalaze istočno od hodnika. Budući da je mrak u Gertrudinoj sobi, trebala bi uzeti lanternu! Nakon toga, trebaš proći južnim prolazom prema Dnevnoj sobi.

You can see Vrata glavne sobe, Velika drvena vrata and Prolaz u dnevni here.

Sad je 11:38 pm, još se stigneš spasiti!

>s
(first opening Prolaz u dnevni)

Dnevna soba
Raskošna dnevna soba s velikim kaminom u kojem gori vatra. Na stolu u kutu nalazi se hrana. Mogla bi si uzeti malo za put. Sjeverno se nalazi Prolaz prema hodniku. Zapadno se nalaze izlazna vrata - tvoj spas!

On Stol is Hrana.

You can also see Izlazna vrata, Prolaz u dnevni, Penelopa and Kleopatra here.

Sad je 11:39 pm, još se stigneš spasiti!

>unlock izlazna vrata
What do you want to unlock Izlazna vrata with?

>with glavni kljuc
You can't see any such thing.

>glavni kljuc
That's not a verb I recognise.

>inventory
You are carrying:
  Glavni kljuc
  Lanterna (providing light)

Sad je 11:40 pm, još se stigneš spasiti!

>Glavni kljuc
That's not a verb I recognise.

>unlock izlazna vrata with glavni kljuc
You unlock Izlazna vrata.

Sad je 11:41 pm, još se stigneš spasiti!

>open izlazna vrata
Otvorila si Izlazna vrata.

You open Izlazna vrata.

Sad je 11:42 pm, još se stigneš spasiti!

>w
Dvoriste
Lia je ovdje, veliki njemački ovčar koji čuva dvorac noću. Moram ju pomaziti da me pusti.

You can also see Izlazna vrata, Penelopa and Kleopatra here.

Sad je 11:43 pm, još se stigneš spasiti!

>e
You can't go that way.

Sad je 11:44 pm, još se stigneš spasiti!

>n
You can't go that way.

Sad je 11:45 pm, još se stigneš spasiti!

>s
Dnevna soba
Raskošna dnevna soba s velikim kaminom u kojem gori vatra. Na stolu u kutu nalazi se hrana. Mogla bi si uzeti malo za put. Sjeverno se nalazi Prolaz prema hodniku. Zapadno se nalaze izlazna vrata - tvoj spas!

On Stol is Hrana.

You can also see Izlazna vrata and Prolaz u dnevni here.

Sad je 11:46 pm, još se stigneš spasiti!

>w
Dvoriste
Lia je ovdje, veliki njemački ovčar koji čuva dvorac noću. Moram ju pomaziti da me pusti.

You can also see Izlazna vrata, Penelopa and Kleopatra here.

Sad je 11:47 pm, još se stigneš spasiti!

>open izlazna vrata
Otvorila si Izlazna vrata.

That's already open.

Sad je 11:48 pm, još se stigneš spasiti!

* * *

>w
Hodnik
U hodniku se nalazi mnogo vrata, no tebi su bitna samo ona od Gertrudine sobe koja se nalaze istočno od hodnika. Budući da je mrak u Gertrudinoj sobi, trebala bi uzeti lanternu! Nakon toga, trebaš proći južnim prolazom prema Dnevnoj sobi.

You can see Vrata glavne sobe, Velika drvena vrata and Prolaz u dnevni here.

Sad je 11:35 pm, još se stigneš spasiti!

>open izlazna vrata
You can't see any such thing.

>s
(first opening Prolaz u dnevni)

Dnevna soba
Raskošna dnevna soba s velikim kaminom u kojem gori vatra. Na stolu u kutu nalazi se hrana. Mogla bi si uzeti malo za put. Sjeverno se nalazi Prolaz prema hodniku. Zapadno se nalaze izlazna vrata - tvoj spas!

On Stol is Hrana.

You can also see Izlazna vrata, Prolaz u dnevni, Penelopa and Kleopatra here.

Sad je 11:36 pm, još se stigneš spasiti!

>open izlazna vrata
Prvo otključaj vrata! Ako nemaš ključ, vrati se u Gertrudinu sobu.

Sad je 11:37 pm, još se stigneš spasiti!

>unlock izlazna vrata
What do you want to unlock Izlazna vrata with?

>glavni kljuc
You unlock Izlazna vrata.

Sad je 11:38 pm, još se stigneš spasiti!

>open izlazna vrata
Otvorila si Izlazna vrata.

You open Izlazna vrata.

Sad je 11:39 pm, još se stigneš spasiti!

* * *

>take lanterna
Taken.

>s
(first opening Prolaz u dnevni)

Dnevna soba
Raskošna dnevna soba s velikim kaminom u kojem gori vatra. Na stolu u kutu nalazi se hrana. Mogla bi si uzeti malo za put. Sjeverno se nalazi Prolaz prema hodniku. Zapadno se nalaze izlazna vrata - tvoj spas!

On Stol is Hrana.

You can also see Izlazna vrata, Prolaz u dnevni, Penelopa and Kleopatra here.

Sad je 11:32 pm, još se stigneš spasiti!

>take hrana
Ovo će dobro doći za put!

>examine
What do you want to examine?

>inventory
You are carrying:
  Hrana
  Lanterna (providing light)

>eat hrana
Ostavi hranu za put.

>inventory
You are carrying:
  Hrana
  Lanterna (providing light)

* * *

>s
(first opening Prolaz u dnevni)

Dnevna soba
Raskošna dnevna soba s velikim kaminom u kojem gori vatra. Na stolu u kutu nalazi se hrana. Mogla bi si uzeti malo za put. Sjeverno se nalazi Prolaz prema hodniku. Zapadno se nalaze izlazna vrata - tvoj spas!

On Stol is Hrana.

You can also see Izlazna vrata, Prolaz u dnevni, Penelopa and Kleopatra here.

Sad je 11:32 pm, još se stigneš spasiti!

>e
Hodnik
U hodniku se nalaze mnogo vrata, no tebi su bitna samo ona od Gertrudine sobe koja se nalaze istočno od hodnika. Budući da je mrak u Gertrudinoj sobi, trebala bi uzeti lanternu! Nakon toga, trebaš proći južnim prolazom prema Dnevnoj sobi.

You can see Prolaz u dnevni, Velika drvena vrata and Vrata glavne sobe here.

>e
(first opening Vrata glavne sobe)
Otvorila si vrata glavne sobe
Glavna soba
Glavna soba je Gertrudina soba, najveća je soba u dvorcu. U njoj se nalazi kraljevski krevet, njezin omiljeni ljubimac hrčak Otto koji je u kavezu, ormar, noćni ormar te komoda. U njoj se također nalazi ključ glavnih vrata dvorca, pronađi ga! Zapadno se nalaze Vrata glavne sobe!

You can see Vrata glavne sobe, Penelopa, Kleopatra, Kavez (in which is Otto), Komoda (closed) and Nocni ormar (closed) here.

>w
Hodnik
U hodniku se nalaze mnogo vrata, no tebi su bitna samo ona od Gertrudine sobe koja se nalaze istočno od hodnika. Budući da je mrak u Gertrudinoj sobi, trebala bi uzeti lanternu! Nakon toga, trebaš proći južnim prolazom prema Dnevnoj sobi.

You can see Vrata glavne sobe, Prolaz u dnevni and Velika drvena vrata here.

>s
Dnevna soba
Raskošna dnevna soba s velikim kaminom u kojem gori vatra. Na stolu u kutu nalazi se hrana. Mogla bi si uzeti malo za put. Istočno se nalazi Prolaz prema hodniku. Sjeverno se nalaze izlazna vrata - tvoj spas!

On Stol is Hrana.

You can also see Prolaz u dnevni and Izlazna vrata here.

* * *

>s
(first opening Prolaz u dnevni)

Dnevna soba
Raskošna dnevna soba s velikim kaminom u kojem gori vatra. Na stolu u kutu nalazi se hrana. Mogla bi si uzeti malo za put. Sjeverno se nalazi Prolaz prema hodniku. Zapadno se nalaze izlazna vrata - tvoj spas!

On Stol is Hrana.

You can also see Izlazna vrata, Prolaz u dnevni, Penelopa and Kleopatra here.

Sad je 11:32 pm, još se stigneš spasiti!

>n
Hodnik
U hodniku se nalazi mnogo vrata, no tebi su bitna samo ona od Gertrudine sobe koja se nalaze istočno od hodnika. Budući da je mrak u Gertrudinoj sobi, trebala bi uzeti lanternu! Nakon toga, trebaš proći južnim prolazom prema Dnevnoj sobi.

You can see Prolaz u dnevni, Velika drvena vrata and Vrata glavne sobe here.

Sad je 11:33 pm, još se stigneš spasiti!

>e
(first opening Vrata glavne sobe)
Otvorila si vrata glavne sobe
Glavna soba
Glavna soba je Gertrudina soba, najveća soba u dvorcu. U njoj se nalazi kraljevski krevet, njezin omiljeni ljubimac tvor Otto koji je u kavezu, ormar, noćni ormar te komoda. U njoj se negdje također nalazi ključ glavnih vrata dvorca, pronađi ga! Zapadno se nalaze Vrata glavne sobe!

You can see Vrata glavne sobe, Penelopa, Kleopatra, Kavez (in which is Otto), Komoda (closed) and Nocni ormar (closed) here.

Sad je 11:34 pm, još se stigneš spasiti!

>open komoda
You open Komoda, revealing Skrinja.

Sad je 11:35 pm, još se stigneš spasiti!

>examine skrinja
Škrinja je zatvorena, moraš nekakav kod upisati da ju otvoriš!

Sad je 11:36 pm, još se stigneš spasiti!

* * *

>take lanterna
Taken.

>a
That's not a verb I recognise.

* * *

>take lanterna
Taken.

>zapali svijeća
You can't see any such thing.

>zapali svijeca
Zapalila si svijeću

>e
Sad imaš izvor svijetlosti pa možeš u Gertrudinu sobu.

(first opening Vrata 1)
Prvo provjeri je li ovo usitinu Gertrudina soba.

>procitaj natpis vrata 1
Znači ovo su Vrata glavne sobe!

Glavna soba - Gertruda

>e
Sad imaš izvor svijetlosti pa možeš u Gertrudinu sobu.

(first opening Vrata glavne sobe.)
Otvorila si vrata glavne sobe
Glavna soba
Glavna soba je Gertrudina soba, najveća soba u dvorcu. U njoj se nalazi kraljevski krevet, njezin omiljeni ljubimac tvor Otto koji je u kavezu, ormar, noćni ormar te komoda. U njoj se negdje također nalazi ključ glavnih vrata dvorca, pronađi ga! Zapadno se nalaze Vrata glavne sobe!

You can see Vrata glavne sobe., Penelopa, Kleopatra, Kavez (in which is Otto), Komoda (closed) and Nocni ormar (closed) here.

>open komoda
You open Komoda, revealing Glavni kljuc.

* * *

>take glavni kljuc
Uzela si kljuc za izlazna vrata.

Taken.

>w
Hodnik
U hodniku se nalazi mnogo vrata, no tebi su bitna samo ona od Gertrudine sobe. Jedini problem je što ne znaš koja vrata vode do njezine sobe. Pročitaj natpise na vratima da saznaš! Budući da je mrak u Gertrudinoj sobi, trebala bi uzeti i lanternu! Nakon toga, trebaš proći južnim prolazom prema Dnevnoj sobi.

You can see Vrata glavne sobe., Velika drvena vrata, Prolaz u dnevni and Vrata 2 here.

>s
(first opening Prolaz u dnevni)

Dnevna soba
Raskošna dnevna soba s velikim kaminom u kojem gori vatra. Na stolu u kutu nalazi se hrana. Mogla bi si uzeti malo za put. Sjeverno se nalazi Prolaz prema hodniku. Zapadno se nalaze izlazna vrata - tvoj spas!

On Stol is Hrana.

You can also see Izlazna vrata, Prolaz u dnevni, Penelopa and Kleopatra here.

>open izlazna vrata
Prvo otključaj vrata s ključem koji si našla
Imaš još 20 minuta da pobjegneš

>inventory
You are carrying:
  Glavni kljuc
  Lanterna
    Svijeca (providing light)

>unlock izlazna vrata
What do you want to unlock Izlazna vrata with?

* * *

>glavni kljuc
You unlock Izlazna vrata.

>n
Hodnik
U hodniku se nalazi mnogo vrata, no tebi su bitna samo ona od Gertrudine sobe. Jedini problem je što ne znaš koja vrata vode do njezine sobe. Pročitaj natpise na vratima da saznaš! Budući da je mrak u Gertrudinoj sobi, trebala bi uzeti i lanternu! Nakon toga, trebaš proći južnim prolazom prema Dnevnoj sobi.

You can see Prolaz u dnevni, Vrata glavne sobe., Velika drvena vrata and Vrata 2 here.

>s
Dnevna soba
Raskošna dnevna soba s velikim kaminom u kojem gori vatra. Na stolu u kutu nalazi se hrana. Mogla bi si uzeti malo za put. Sjeverno se nalazi Prolaz prema hodniku. Zapadno se nalaze izlazna vrata - tvoj spas!

On Stol is Hrana.

You can also see Prolaz u dnevni, Izlazna vrata, Penelopa and Kleopatra here.

>w
(first opening Izlazna vrata)
Otvorila si Izlazna vrata.

Dvoriste
Lia je ovdje, veliki njemački ovčar koji čuva dvorac noću. Moram ju pomaziti da me pusti.

You can also see Izlazna vrata, Penelopa and Kleopatra here.

>pomazi lia
*** Čestitam, uspjela si se spasiti! Odletjela si na Penelopi. ***

Would you like to RESTART, RESTORE a saved game, QUIT or UNDO the last command?

* * *

>take lanterna
Taken.

>zapali svijeca
Zapalila si svijeću

* * *

>e
Sad imaš izvor svijetlosti pa možeš u Gertrudinu sobu.

(first opening Vrata glavne sobe.)
Otvorila si vrata glavne sobe
Glavna soba
Glavna soba je Gertrudina soba, najveća soba u dvorcu. U njoj se nalazi kraljevski krevet, njezin omiljeni ljubimac tvor Otto koji je u kavezu, ormar, noćni ormar te komoda. U njoj se negdje također nalazi ključ glavnih vrata dvorca, pronađi ga! Zapadno se nalaze Vrata glavne sobe!

You can see Vrata glavne sobe., Penelopa, Kleopatra, Kavez (in which is Otto), Komoda (closed) and Nocni ormar (closed) here.

>open komoda
Vidi tu je glavni ključ!

You open Komoda, revealing Glavni kljuc.

>examine glavni kljuc
Starinski zlatni ključ koji oključava glavna vrata dvorca.

>examine komoda
Velika drvena komoda napravljena od hrasta i stakla. Pogledaj je li u njoj negdje ključ.

In Komoda is Glavni kljuc.

>take glavni kljuc
Uzela si kljuc za izlazna vrata.

Taken.

>ask penelopa about vrijeme
Sada je 11:40 pm.
Imaš još 20 minuta da pobjegneš

>ask penelopa about hrana
Mislim da bi trebali ponijeti nešto za pojest

* * *

>ask penelopa about bijeg
Mislim da bolju šansu nećemo imati!

>ask penelopa about trm
Ne znam što bih rekla.

>w
Hodnik
U hodniku se nalazi mnogo vrata, no tebi su bitna samo ona od Gertrudine sobe. Jedini problem je što ne znaš koja vrata vode do njezine sobe. Pročitaj natpise na vratima da saznaš! Budući da je mrak u Gertrudinoj sobi, trebala bi uzeti i lanternu! Nakon toga, trebaš proći južnim prolazom prema Dnevnoj sobi.

You can see Vrata glavne sobe., Velika drvena vrata, Prolaz u dnevni and Vrata 2 here.

>drop glavni kljuc
Dropped.

>s
(first opening Prolaz u dnevni)

Dnevna soba
Raskošna dnevna soba s velikim kaminom u kojem gori vatra. Na stolu u kutu nalazi se hrana. Mogla bi si uzeti malo za put. Sjeverno se nalazi Prolaz prema hodniku. Zapadno se nalaze izlazna vrata - tvoj spas!

On Stol is Hrana.

You can also see Izlazna vrata, Prolaz u dnevni, Penelopa and Kleopatra here.

>unlock izlazna vrata
(with Lanterna)
That doesn't seem to fit the lock.

>open izlazna vrata
Prvo otključaj vrata s ključem koji si našla.

>w
(first opening Izlazna vrata)
Prvo otključaj vrata s ključem koji si našla.

>n
Hodnik
U hodniku se nalazi mnogo vrata, no tebi su bitna samo ona od Gertrudine sobe. Jedini problem je što ne znaš koja vrata vode do njezine sobe. Pročitaj natpise na vratima da saznaš! Budući da je mrak u Gertrudinoj sobi, trebala bi uzeti i lanternu! Nakon toga, trebaš proći južnim prolazom prema Dnevnoj sobi.

You can see Prolaz u dnevni, Glavni kljuc, Vrata glavne sobe., Velika drvena vrata and Vrata 2 here.

Imaš još 10 minuta da pobjegneš!

>take glavni kljuc
Uzela si kljuc za izlazna vrata.

Taken.

>s
Dnevna soba
Raskošna dnevna soba s velikim kaminom u kojem gori vatra. Na stolu u kutu nalazi se hrana. Mogla bi si uzeti malo za put. Sjeverno se nalazi Prolaz prema hodniku. Zapadno se nalaze izlazna vrata - tvoj spas!

On Stol is Hrana.

You can also see Prolaz u dnevni, Izlazna vrata, Penelopa and Kleopatra here.

>unlock izlazna vrata
What do you want to unlock Izlazna vrata with?

* * *

>glavni kljuc
You unlock Izlazna vrata.

>w
(first opening Izlazna vrata)
Otvorila si Izlazna vrata.

Dvoriste
Lia je ovdje, veliki njemački ovčar koji čuva dvorac noću. Moram ju pomaziti da me pusti.

You can also see Izlazna vrata, Penelopa and Kleopatra here.

>pomazi penelopa
Liu trebaš pomaziti da te pusti.

>pomazi kleopatra
Liu trebaš pomaziti da te pusti.

>pomazi vrata
You can only do that to something animate.

>ask penelopa about vrijeme
Sada je 11:57 pm.

>ask penelopa about hrana
Mislim da bi trebali ponijeti nešto za pojest

>ask penelopa about vrijeme
Sada je 11:59 pm.

>ask penelopa about vrijeme
Sada je 12:00 am.

    *** Nažalost, ponoć je prošla te se Gertruda vratila u dvorac. :( ***

Would you like to RESTART, RESTORE a saved game, QUIT or UNDO the last command?

* * *

>s
(first opening Velika drvena vrata)
Otvorila si vrata svoje sobe.

Hodnik
U hodniku se nalazi mnogo vrata, no tebi su bitna samo ona od Gertrudine sobe. Jedini problem je što ne znaš koja vrata vode do njezine sobe. Pročitaj natpise na vratima da saznaš! Budući da je mrak u Gertrudinoj sobi, trebala bi uzeti i lanternu! Nakon toga, trebaš proći južnim prolazom prema Dnevnoj sobi.

You can see Velika drvena vrata, Prolaz u dnevni, Vrata 1, Lanterna (in which is Svijeca) and Vrata 2 here.

>n
Matovilkina soba
Tvoja soba nalazi se u tornju dvorca. Iznenađujuće, soba je poprilično velika te se u njoj nalazi predivan veliki krevet, ormar, violina te sve potrebno za Kleopatru i Penelopu. Ono što te podsječa na tvoje zatočeništvo su dva prozora sa željeznim rešetkama.

Južno od sobe nalazi se hodnik.

You can see Velika drvena vrata, Penelopa and Kleopatra here.

>s
Hodnik
U hodniku se nalaze mnogo vrata, no tebi su bitna samo ona od Gertrudine sobe koja se nalaze istočno od hodnika. Budući da je mrak u Gertrudinoj sobi, trebala bi uzeti lanternu! Nakon toga, trebaš proći južnim prolazom prema Dnevnoj sobi.

You can see Velika drvena vrata, Prolaz u dnevni, Vrata glavne sobe and Lanterna here.

>e
U glavnoj sobi je premračno! Uzmi lanternu.

>take lanterna
Uzela si lanternu. Sad možeš u Gertrudinu sobu.

Taken.

>e
(first opening Vrata glavne sobe)
Otvorila si vrata glavne sobe
Glavna soba
Glavna soba je Gertrudina soba, najveća je soba u dvorcu. U njoj se nalazi kraljevski krevet, njezin omiljeni ljubimac hrčak Otto koji je u kavezu, ormar, noćni ormar te komoda. U njoj se također nalazi ključ glavnih vrata dvorca, pronađi ga! Zapadno se nalaze Vrata glavne sobe!

You can see Vrata glavne sobe, Penelopa, Kleopatra, Kavez (in which is Otto), Komoda (closed) and Nocni ormar (closed) here.

>w
Hodnik
U hodniku se nalaze mnogo vrata, no tebi su bitna samo ona od Gertrudine sobe koja se nalaze istočno od hodnika. Budući da je mrak u Gertrudinoj sobi, trebala bi uzeti lanternu! Nakon toga, trebaš proći južnim prolazom prema Dnevnoj sobi.

You can see Vrata glavne sobe, Velika drvena vrata and Prolaz u dnevni here.

* * *

>s
(first opening Prolaz u dnevni)

Dnevna soba
Raskošna dnevna soba s velikim kaminom u kojem gori vatra. Na stolu u kutu nalazi se hrana. Mogla bi si uzeti malo za put. Istočno se nalazi Prolaz prema hodniku. Sjeverno se nalaze izlazna vrata - tvoj spas!

On Stol is Hrana.

You can also see Izlazna vrata, Prolaz u dnevni, Penelopa and Kleopatra here.

>e
Hodnik
U hodniku se nalaze mnogo vrata, no tebi su bitna samo ona od Gertrudine sobe koja se nalaze istočno od hodnika. Budući da je mrak u Gertrudinoj sobi, trebala bi uzeti lanternu! Nakon toga, trebaš proći južnim prolazom prema Dnevnoj sobi.

You can see Prolaz u dnevni, Vrata glavne sobe and Velika drvena vrata here.

>e
Glavna soba
Glavna soba je Gertrudina soba, najveća je soba u dvorcu. U njoj se nalazi kraljevski krevet, njezin omiljeni ljubimac hrčak Otto koji je u kavezu, ormar, noćni ormar te komoda. U njoj se također nalazi ključ glavnih vrata dvorca, pronađi ga! Zapadno se nalaze Vrata glavne sobe!

You can see Vrata glavne sobe, Kavez (in which is Otto), Komoda (closed) and Nocni ormar (closed) here.

>w
Hodnik
U hodniku se nalaze mnogo vrata, no tebi su bitna samo ona od Gertrudine sobe koja se nalaze istočno od hodnika. Budući da je mrak u Gertrudinoj sobi, trebala bi uzeti lanternu! Nakon toga, trebaš proći južnim prolazom prema Dnevnoj sobi.

You can see Vrata glavne sobe, Prolaz u dnevni and Velika drvena vrata here.

>s
Dnevna soba
Raskošna dnevna soba s velikim kaminom u kojem gori vatra. Na stolu u kutu nalazi se hrana. Mogla bi si uzeti malo za put. Istočno se nalazi Prolaz prema hodniku. Sjeverno se nalaze izlazna vrata - tvoj spas!

On Stol is Hrana.

You can also see Prolaz u dnevni, Izlazna vrata, Penelopa and Kleopatra here.

* * *

>s
(first opening Velika drvena vrata)
Otvorila si vrata svoje sobe.

Hodnik
U hodniku se nalazi mnogo vrata, no tebi su bitna samo ona od Gertrudine sobe. Jedini problem je što ne znaš koja vrata vode do njezine sobe. Pročitaj natpise na vratima da saznaš! Budući da je mrak u Gertrudinoj sobi, trebala bi uzeti i lanternu! Nakon toga, trebaš proći južnim prolazom prema Dnevnoj sobi.

You can see Velika drvena vrata, Prolaz u dnevni, Vrata 1, Lanterna (in which is Svijeca) and Vrata 2 here.

>examine vrata glavne sobe
Predivna drvena vrata koja možda vode do sobe u koju trebaš ići.

Sad je 11:31 pm, još se stigneš spasiti!

>procitaj natpis vrata glavne sobe
Glavna soba - Gertruda.
Sad je 11:32 pm, još se stigneš spasiti!

>examine vrata glavne sobe
Predivna drvena vrata koja vode do Gertrudine sobe. Nalaze se istočno od hodnika.

Sad je 11:33 pm, još se stigneš spasiti!

>e
U glavnoj sobi je premračno! Uzmi lanternu.

Sad je 11:34 pm, još se stigneš spasiti!

>take lanterna
Taken.

Sad je 11:35 pm, još se stigneš spasiti!

>e
Moraš upaliti svijeću u lanterni.

Sad je 11:36 pm, još se stigneš spasiti!

>zapali svijeca
Zapalila si svijeću
Sad je 11:37 pm, još se stigneš spasiti!

>e
Sad imaš izvor svijetlosti pa možeš u Gertrudinu sobu.

(first opening Vrata glavne sobe.)
Otvorila si vrata glavne sobe
Glavna soba
Glavna soba je Gertrudina soba, najveća soba u dvorcu. U njoj se nalazi kraljevski krevet, njezin omiljeni ljubimac tvor Otto koji je u kavezu, ormar, noćni ormar te komoda. U njoj se negdje također nalazi ključ glavnih vrata dvorca, pronađi ga! Zapadno se nalaze Vrata glavne sobe!

You can see Vrata glavne sobe., Penelopa, Kleopatra, Kavez (in which is Otto), Komoda (closed) and Nocni ormar (closed) here.

Sad je 11:38 pm, još se stigneš spasiti!

* * *

>s
(first opening Velika drvena vrata)
Otvorila si vrata svoje sobe.

Hodnik
U hodniku se nalazi mnogo vrata, no tebi su bitna samo ona od Gertrudine sobe. Jedini problem je što ne znaš koja vrata vode do njezine sobe. Pročitaj natpise na vratima da saznaš! Budući da je mrak u Gertrudinoj sobi, trebala bi uzeti i lanternu! Nakon toga, trebaš proći južnim prolazom prema Dnevnoj sobi.

You can see Velika drvena vrata, Prolaz u dnevni, Vrata 1, Lanterna (in which is Svijeca) and Vrata 2 here.

>procitaj natpis Vrata 2
Kriva soba nažalost.

>procitaj natpis Vrata 1
Ovo su Vrata glavne sobe

Glavna soba - Gertruda.

>examine vrata 1
You can't see any such thing.

>examine velika drvena vrata
Vrata tvoje sobe koja vode u hodnik.

>examine vrata glavne sobe
Predivna drvena vrata koja vode do Gertrudine sobe. Nalaze se istočno od hodnika.

* * *

>prozori
That's not a verb I recognise.

* * *

>examine prozori
Dva prozora koja se protežu od poda do stropa, predivnog zaobljenog oblika. Ukrašavaju ih raskošne zlatne zavjese i željezne rešetke. Da nema rešetki, već bi odletjela na Penelopi.

>take prozori
Kako si mislila ponijeti prozore?!

>take violina
Bit će malo teže pobjeći s ovim, ali ne mogu je ostaviti tu.

Taken.

>s
(first opening Velika drvena vrata)
Otvorila si vrata svoje sobe.

Hodnik
U hodniku se nalazi mnogo vrata, no tebi su bitna samo ona od Gertrudine sobe. Jedini problem je što ne znaš koja vrata vode do njezine sobe. Pročitaj natpise na vratima da saznaš! Budući da je mrak u Gertrudinoj sobi, trebala bi uzeti i lanternu! Nakon toga, trebaš proći južnim prolazom prema Dnevnoj sobi.

You can see Velika drvena vrata, Prolaz u dnevni, Vrata 1, Lanterna (in which is Svijeca) and Vrata 2 here.

* * *

>procitaj natpis Vrata 2
Kriva soba nažalost.

>examine vrata 1
Predivna drvena vrata koja možda vode do sobe u koju trebaš ići.

>procitaj natpis Vrata 1
Znači ovo su Vrata glavne sobe!

Glavna soba - Gertruda

>examine Vrata glavne sobe
Predivna drvena vrata koja vode do Gertrudine sobe. Nalaze se istočno od hodnika.

>e
U glavnoj sobi je premračno! Uzmi lanternu.

>take lanterna
Taken.

>inventory
You are carrying:
  Lanterna
    Svijeca
  Violina

Imaš još 20 minuta da pobjegneš

>e
Moraš upaliti svijeću u lanterni.

>zapali svijeca
Zapalila si svijeću

>inventory
You are carrying:
  Lanterna
    Svijeca (providing light)
  Violina

>e
Sad imaš izvor svijetlosti pa možeš u Gertrudinu sobu.

(first opening Vrata glavne sobe.)
Otvorila si vrata glavne sobe
Glavna soba
Glavna soba je Gertrudina soba, najveća soba u dvorcu. U njoj se nalazi kraljevski krevet, njezin omiljeni ljubimac tvor Otto koji je u kavezu, ormar, noćni ormar te komoda. U njoj se negdje također nalazi ključ glavnih vrata dvorca, pronađi ga! Zapadno se nalaze Vrata glavne sobe!

You can see Vrata glavne sobe., Penelopa, Kleopatra, Kavez (in which is Otto), Komoda (closed) and Nocni ormar (closed) here.

>examine komoda
Velika drvena komoda napravljena od hrasta i stakla. Pogledaj je li u njoj negdje ključ.

>examine nocni ormar
Drveni noćni ormarić s jednom ladicom, pogledaj što se nalazi u njemu!

>take otto
Ne možeš ga uzeti. Micika će ga pojest.

>open nocni ormar
You open Nocni ormar, revealing Dnevnik.

* * *

>examine dnevnik
Običan prastari dnevnik u kojem tvoja zla maćeha vjerojatno opisuje kako muči ljude!

>open komoda
You open Komoda, revealing Glavni kljuc.

Imaš još 10 minuta da pobjegneš!

>examine komoda
Vidi, u njoj se nalazi glavni kljuc!

In Komoda is Glavni kljuc.

>take glavni kljuc
Uzela si kljuc za izlazna vrata.

Taken.

* * *

>s
(first opening Prolaz u dnevni)

Dnevna soba
Raskošna dnevna soba s velikim kaminom u kojem gori vatra. Na stolu u kutu nalazi se hrana. Mogla bi si uzeti malo za put. Sjeverno se nalazi Prolaz prema hodniku. Zapadno se nalaze izlazna vrata - tvoj spas!

On Stol is Hrana.

You can also see Izlazna vrata, Prolaz u dnevni, Penelopa and Kleopatra here.

>examine hrana
Grožđe, sir, rajčica, masline i šipak!

>ask penelopa about hrana
Mislim da bi trebali ponijeti nešto za pojest

>take hrana
Ovo će dobro doći za put!

* * *

>eat hrana
Ostavi hranu za put. Trebat će ti!

>ask penelopa about vrijeme
Sada je 11:59 pm.

>a
That's not a verb I recognise.

>open izlazna vrata
Prvo otključaj vrata s ključem koji si našla

    *** Nažalost, ponoć je prošla te se Gertruda vratila u dvorac. :( ***

Would you like to RESTART, RESTORE a saved game, QUIT or UNDO the last command?

>restart
Bijeg iz dvorca
An Interactive Fiction by Barbara Tatai
Release 1 / Serial number 220130 / Inform 7 build 6M62 (I6/v6.33 lib 6/12N) SD

Ime ti je Matovilka te otkako znaš za sebe zatočena si u dvorcu. Svaku večer te tvoja zla maćeha Gertruda zaključa u tvoju sobu s tvojim vjernim prijateljicama, zmajem Penelopom i mačkom Kleopatrom. Cijeli život si čekala priliku da Gertruda pogriješi, a danas si ju dočekala. Gertruda te u žurbi na novogodišnji bal zaboravila zaključati, a  znaš da se kopija ključa glavnog izlaza nalazi negdje u njezinoj sobi. Odlučila si zgrabiti ovu priliku te napokon pobjeći i biti slobodna. Imaš vremena do ponoći da pobjegneš!

Matovilkina soba
Tvoja soba nalazi se u tornju dvorca. Iznenađujuće, soba je poprilično velika te se u njoj nalazi predivan veliki krevet, ormar, violina te sve potrebno za Kleopatru i Penelopu. Ono što te podsječa na tvoje zatočeništvo su dva prozora sa željeznim rešetkama.

Južno od sobe nalazi se hodnik.

You can see Velika drvena vrata, Violina, Penelopa and Kleopatra here.

>s
(first opening Velika drvena vrata)
Otvorila si vrata svoje sobe.

Hodnik
U hodniku se nalazi mnogo vrata, no tebi su bitna samo ona od Gertrudine sobe. Jedini problem je što ne znaš koja vrata vode do njezine sobe. Pročitaj natpise na vratima da saznaš! Budući da je mrak u Gertrudinoj sobi, trebala bi uzeti i lanternu! Nakon toga, trebaš proći južnim prolazom prema Dnevnoj sobi.

You can see Velika drvena vrata, Prolaz u dnevni, Vrata 1, Lanterna (in which is Svijeca) and Vrata 2 here.

* * *

>s
(first opening Prolaz u dnevni)

Dnevna soba
Raskošna dnevna soba s velikim kaminom u kojem gori vatra. Na stolu u kutu nalazi se hrana. Mogla bi si uzeti malo za put. Sjeverno se nalazi Prolaz prema hodniku. Zapadno se nalaze izlazna vrata - tvoj spas!

On Stol is Hrana.

You can also see Izlazna vrata, Prolaz u dnevni, Penelopa and Kleopatra here.

>unlock izlazna vrata
What do you want to unlock Izlazna vrata with?

>glavni kljuc
You unlock Izlazna vrata.

Imaš još 20 minuta da pobjegneš

>w
(first opening Izlazna vrata)
Otvorila si Izlazna vrata.

Dvoriste
Lia je ovdje, veliki njemački ovčar koji čuva dvorac noću. Moram ju pomaziti da me pusti.

You can also see Izlazna vrata, Penelopa and Kleopatra here.

>pomazi nest
You can't see any such thing.

>pomazi penelopa
Liu trebaš pomaziti da te pusti.

>pomazi lia
*** Čestitam, uspjela si se spasiti! Odletjela si na Penelopi. ***

Would you like to RESTART, RESTORE a saved game, QUIT or UNDO the last command?

* * *

>e
You can't go that way.

>j
That's not a verb I recognise.

>s
(first opening Velika drvena vrata)

Hodnik
U hodniku postoji mnogo vrata, no tebi su bitna samo ona od Gertrudine sobe koja se nalaze istočno od hodnika. Budući da je mrak u Gertrudinoj sobi, trebala bi uzeti svjetiljku!

You can see Velika drvena vrata, Vrata glavne sobe and Svjetiljka here.

>e
(first opening Vrata glavne sobe)

Darkness
It is pitch dark, and you can't see a thing.

>examine
What do you want to examine?

>take svjetiljka
You can't see any such thing.

>take Svjetiljka
You can't see any such thing.

>w
Hodnik
U hodniku postoji mnogo vrata, no tebi su bitna samo ona od Gertrudine sobe koja se nalaze istočno od hodnika. Budući da je mrak u Gertrudinoj sobi, trebala bi uzeti svjetiljku!

You can see Vrata glavne sobe, Velika drvena vrata and Svjetiljka here.

>take svjetiljka
Taken.

* * *

>e
You can't go that way.

>s
(first opening Velika drvena vrata)
Otvorila si vrata svoje sobe.

Hodnik
U hodniku postoji mnogo vrata, no tebi su bitna samo ona od Gertrudine sobe koja se nalaze istočno od hodnika. Budući da je mrak u Gertrudinoj sobi, trebala bi uzeti lanternu! Nakon toga, trebaš proći južnim prolazom prema Dnevnoj sobi.

You can see Velika drvena vrata, Prolaz u dnevni, Vrata glavne sobe and Lanterna here.

>e
U glavnoj sobi je premračno! Uzmi lanternu.

>take lanterna
Uzela si lanternu. Sad možeš u sobu.

>e
(first opening Vrata glavne sobe)
Otvorila si vrata glavne sobe
Glavna soba
Glavna soba je Gertrudina soba, najveća je soba u dvorcu. U njoj se nalazi kraljevski krevet, njezin omiljeni ljubimac Hrčak koji je u kavezu, ormar, noćni ormar te komoda. U njoj se također nalazi ključ glavnih vrata dvorca, pronađi ga! Zapadno se nalaze Vrata glavne sobe!

You can see Vrata glavne sobe, Penelopa, Kleopatra, Komoda (closed) and Nocni ormar (closed) here.

>open komoda
You open Komoda, revealing Glavni kljuc.

* * *

>take glavni kljuc
Taken.

>w
Hodnik
U hodniku postoji mnogo vrata, no tebi su bitna samo ona od Gertrudine sobe koja se nalaze istočno od hodnika. Budući da je mrak u Gertrudinoj sobi, trebala bi uzeti lanternu! Nakon toga, trebaš proći južnim prolazom prema Dnevnoj sobi.

You can see Vrata glavne sobe, Velika drvena vrata and Prolaz u dnevni here.

>s
(first opening Prolaz u dnevni)

Dnevna soba
Raskošna dnevna soba s velikim kaminom u kojem gori vatra. Na stolu u kutu nalazi se hrana. Mogla bi si uzeti malo za put. Istočno se nalazi Prolaz prema hodniku. Sjeverno se nalaze izlazna vrata - tvoj spas!

On Stol is Hrana.

You can also see Izlazna vrata, Prolaz u dnevni, Penelopa and Kleopatra here.

>examine izlazna vrata
Najveća vrata koja su izlaz iz dvorca. Stara su i škripe, pazi kako ih otvaraš!

>n
(first opening Izlazna vrata)
Treba ti ključ!

>open izlazna vrata
Treba ti ključ!

>unlock izlazna vrata
What do you want to unlock Izlazna vrata with?

* * *

>glavni kljuc
You unlock Izlazna vrata.

>n
(first opening Izlazna vrata)
Otvorila si Izlazna vrata.

Dvoriste
You can see Izlazna vrata, Penelopa and Kleopatra here.

* * *

>e
(first opening Vrata glavne sobe)
Otvorila si vrata glavne sobe
Glavna soba
Glavna soba je Gertrudina soba, najveća je soba u dvorcu. U njoj se nalazi kraljevski krevet, njezin omiljeni ljubimac Hrčak koji je u kavezu, ormar, noćni ormar te komoda. U njoj se također nalazi ključ glavnih vrata dvorca, pronađi ga! Zapadno se nalaze Vrata glavne sobe!

You can see Vrata glavne sobe, Penelopa, Kleopatra, Komoda (closed) and Nocni ormar (closed) here.

>examine kavez
Kavez u kojem je mali slatki hrčak. Dobro da je u kavezu jer bi ga Kleopatra inače imala za večeru!

In Kavez is Hr ak.

>examine hrcak
You can't see any such thing.

>examine Hrcak
You can't see any such thing.

>open komoda
You open Komoda, revealing Glavni kljuc.

>open nocni ormar
You open Nocni ormar.

>take glavni kljuc
Uzela si kljuc za izlazna vrata.

>inventory
You are carrying:
  Glavni kljuc
  Lanterna (providing light)

>w
Hodnik
U hodniku postoji mnogo vrata, no tebi su bitna samo ona od Gertrudine sobe koja se nalaze istočno od hodnika. Budući da je mrak u Gertrudinoj sobi, trebala bi uzeti lanternu! Nakon toga, trebaš proći južnim prolazom prema Dnevnoj sobi.

You can see Vrata glavne sobe, Velika drvena vrata and Prolaz u dnevni here.

* * *

>ask penelopa about bijeg
Mislim da bolju šansu nećemo imati!

>ask penelopa about aaa
Nema odgovora.

* * *

>ask penelopa about bijeg
Mislim da bolju šansu nećemo imati!

>ask penelopa about vrijeme
Sada je 11:31 pm.

>take prozori
Kako si mislila ponijeti prozore?!

* * *

>take violina
Bit će malo teže pobjeći s ovim, ali ne mogu je ostaviti tu.

Taken.

>examine prozori
Dva prozora koja se protežu od poda do stropa, predivnog zaobljenog oblika. Ukrašavaju ih raskošne zlatne zavjese i željezne rešetke. Da nema rešetki, već bi odletjela na Penelopi.

>ask penelopa about sati
Ne znam što bih rekla.

>s
(first opening Velika drvena vrata)
Otvorila si vrata svoje sobe.

Hodnik
U hodniku se nalazi mnogo vrata, no tebi su bitna samo ona od Gertrudine sobe. Jedini problem je što ne znaš koja vrata vode do njezine sobe. Pročitaj natpise na vratima da saznaš! Budući da je mrak u Gertrudinoj sobi, trebala bi uzeti i lanternu! Nakon toga, trebaš proći južnim prolazom prema Dnevnoj sobi.

You can see Velika drvena vrata, Prolaz u dnevni, Vrata 1, Lanterna (in which is Svijeca) and Vrata 2 here.

>procitaj natpis vrata 2
Kriva soba nažalost.

>examine vrata 1
Predivna drvena vrata koja možda vode do sobe u koju trebaš ići.

>procitaj natpis vrata 1
Znači ovo su Vrata glavne sobe!

Glavna soba - Gertruda

>examine vrata glavne sobe
Predivna drvena vrata koja vode do Gertrudine sobe. Nalaze se istočno od hodnika.

Imaš još 20 minuta da pobjegneš

>e
U glavnoj sobi je premračno! Uzmi lanternu.

* * *

>take lanterna
Taken.

>inventory
You are carrying:
  Lanterna
    Svijeca
  Violina

>e
Moraš upaliti svijeću u lanterni.

* * *

>e
Sad imaš izvor svijetlosti pa možeš u Gertrudinu sobu.

(first opening Vrata glavne sobe.)
Otvorila si vrata glavne sobe
Glavna soba
Glavna soba je Gertrudina soba, najveća soba u dvorcu. U njoj se nalazi kraljevski krevet, njezin omiljeni ljubimac tvor Otto koji je u kavezu, ormar, noćni ormar te komoda. U njoj se negdje također nalazi ključ glavnih vrata dvorca, pronađi ga! Zapadno se nalaze Vrata glavne sobe!

You can see Vrata glavne sobe., Penelopa, Kleopatra, Kavez (in which is Otto), Komoda (closed) and Nocni ormar (closed) here.

>open nocni ormar
You open Nocni ormar, revealing Dnevnik.

>take dnevnik
Uzela si Gertrudin dnevnik.

Taken.

>take otto
Ne možeš ga uzeti. Micika će ga pojest.

Imaš još 10 minuta da pobjegneš!

>open komoda
You open Komoda, revealing Glavni kljuc.

* * *

>eat hrana
Ostavi hranu za put. Trebat će ti!

>open izlazna vrata
Prvo otključaj vrata s ključem koji si našla

>unlock izlazna vrata
What do you want to unlock Izlazna vrata with?

* * *

>ask penelopa
What do you want to ask Penelopa for?

>bijeg
You can't see any such thing.

>ask penelopa about Penelopa mislis li da je ovo pravi trenutak za bijeg
Mislim da bolju sansu nećemo imati!

* * *

I beg your pardon?

* * *

>pogledaj
I didn't understand that sentence.

* * *

>slika
I didn't understand that sentence.

* * *

>glavni kljuc
That's not a verb I recognise.

>kljuc
That's not a verb I recognise.

* * *

>aks penelopa about bijeg
That's not a verb I recognise.

>ask Penelopa about Bijeg
Mislim da bolju šansu nećemo imati!

>ask penelopa about vrijeme
Sada je 9:01 pm

* * *

>examine matovilkina soba
You can't see any such thing.

>examine prozori
Dva prozora koja se protežu od poda do stropa, predivnog zaobljenog oblika. Ukrašavaju ih raskošne zlatne zavjese i željezne rešetke. Da nema rešetki, već bi odletjela na Penelopi.

>examine penelopa
Penelopa je manja vrsta zmaja ljubičaste boje. Kao mala si ju pronašla u šumi zajedno s Kleopatrom. Penelopa je, iako godinama s tobom, vrlo mlad zmaj te ne zna još rigati vatru. Da zna, odavno bi zapalila Gertrudu!

>examine kleopatra
Kleopatra je bijela micika koja te vjerno prati svuda. Vrlo je umiljata, osim kad vidi Gertrudu.

>s
(first opening Velika drvena vrata)
Otvorila si vrata svoje sobe.

Hodnik
U hodniku se nalaze mnogo vrata, no tebi su bitna samo ona od Gertrudine sobe koja se nalaze istočno od hodnika. Budući da je mrak u Gertrudinoj sobi, trebala bi uzeti lanternu! Nakon toga, trebaš proći južnim prolazom prema Dnevnoj sobi.

You can see Velika drvena vrata, Prolaz u dnevni, Vrata glavne sobe and Lanterna here.

>e
U glavnoj sobi je premračno! Uzmi lanternu.

>take lanterna
Uzela si lanternu. Sad možeš u Gertrudinu sobu.

>examine lanterna
Mala tamno zelena lanterna.

>e
(first opening Vrata glavne sobe)
Otvorila si vrata glavne sobe
Glavna soba
Glavna soba je Gertrudina soba, najveća je soba u dvorcu. U njoj se nalazi kraljevski krevet, njezin omiljeni ljubimac Hrčak koji je u kavezu, ormar, noćni ormar te komoda. U njoj se također nalazi ključ glavnih vrata dvorca, pronađi ga! Zapadno se nalaze Vrata glavne sobe!

You can see Vrata glavne sobe, Penelopa, Kleopatra, Kavez (in which is Otto), Komoda (closed) and Nocni ormar (closed) here.

>examine krevet
Gertrudin kraljevski krevet.

>examine hrčak
You can't see any such thing.

>examine otto
Gertrudin ljubimac.

>examine kavez
Kavez u kojem je tvor Otto. Dobro da je u kavezu jer bi ga Kleopatra inače imala za večeru!

In Kavez is Otto.

>take kavez
Ne možeš ga uzeti.

>open komoda
You open Komoda, revealing Glavni kljuc.

* * *

>examine komoda
Velika drvena komoda napravljena od hrasta i stakla. Pogledaj je li u njoj negdje ključ.

In Komoda is Glavni kljuc.

>examine glavni kljuc
Starinski ključ koji oključava glavna vrata dvorca.

>take glavni kljuc
Uzela si kljuc za izlazna vrata.

>open nocni ormar
You open Nocni ormar, revealing Dnevnik.

* * *

>examine vatra
Čuje se pucketanje vatre u kaminu.

>examine kamin
Ogroman kamin od cigle.

>examine stol
Stol u kutu sobe s voćem.

On Stol is Hrana.

>examine hrana
Grožđe, sir, rajčica, masline i šipak!

>take hrana
Ovo će dobro doći za put!

* * *

>ask penelopa about hrana
Mislim da bi trebali ponijeti nešto za pojest

>n
(first opening Izlazna vrata)
Prvo otključaj vrata! Ako nemaš ključ, vrati se u Gertrudinu sobu.

>open izlazna vrata
Prvo otključaj vrata! Ako nemaš ključ, vrati se u Gertrudinu sobu.

>unlock izlazna vrata
What do you want to unlock Izlazna vrata with?

* * *

>glavni kljuc
You unlock Izlazna vrata.

>n
(first opening Izlazna vrata)
Otključala si vrata.

Otvorila si Izlazna vrata.

    *** Čestitam, uspjela si se spasiti! Možeš odletjeti na Penelopi. ***

Would you like to RESTART, RESTORE a saved game, QUIT or UNDO the last command?

* * *

>examine krevet
You can't see any such thing.

* * *

>take prozori
Kako si mislila ponijeti prozore?!

Sad je 11:30 pm, još se stigneš spasiti!

>inventory
You are carrying nothing.

Sad je 11:31 pm, još se stigneš spasiti!

>examine prozori
Dva prozora koja se protežu od poda do stropa, predivnog zaobljenog oblika. Ukrašavaju ih raskošne zlatne zavjese i željezne rešetke. Da nema rešetki, već bi odletjela na Penelopi.

>examine kleopatra
Kleopatra je bijela micika koja te vjerno prati svuda. Vrlo je umiljata, osim kad vidi Gertrudu.

* * *

>examine penelopa
Penelopa je manja vrsta zmaja ljubičaste boje. Kao mala si ju pronašla u šumi zajedno s Kleopatrom. Penelopa je, iako godinama s tobom, vrlo mlad zmaj te ne zna još rigati vatru. Da zna, odavno bi zapalila Gertrudu!

* * *

>s
(first opening Velika drvena vrata)
Otvorila si vrata svoje sobe.

Hodnik
U hodniku se nalazi mnogo vrata, no tebi su bitna samo ona od Gertrudine sobe koja se nalaze istočno od hodnika. Budući da je mrak u Gertrudinoj sobi, trebala bi uzeti lanternu! Nakon toga, trebaš proći južnim prolazom prema Dnevnoj sobi.

You can see Velika drvena vrata, Prolaz u dnevni, Vrata glavne sobe and Lanterna here.

>e
U glavnoj sobi je premračno! Uzmi lanternu.

>examine lanterna
Mala tamno zelena lanterna.

>take lanterna
Uzela si lanternu. Sad možeš u Gertrudinu sobu.

Taken.

>e
(first opening Vrata glavne sobe)
Otvorila si vrata glavne sobe

>examine krevet
You can't see any such thing.

>examine kavez
You can't see any such thing.

>examine otto
You can't see any such thing.

>take otto
You can't see any such thing.

>inventory
You are carrying:
  Lanterna (providing light)

>take kavez
You can't see any such thing.

>examine komoda
You can't see any such thing.

>open komoda
You can't see any such thing.

>examine glavni kljuc
You can't see any such thing.

>take glavni kljuc
You can't see any such thing.

>examine nocni ormar
You can't see any such thing.

>open nocni ormar
You can't see any such thing.

>examine dnevnik
You can't see any such thing.

>take dnevnik
You can't see any such thing.

>inventory
You are carrying:
  Lanterna (providing light)

>w
You can't go that way.

>s
(first opening Prolaz u dnevni)

>n
Matovilkina soba
Tvoja soba nalazi se u tornju dvorca. Iznenađujuće, soba je poprilično velika te se u njoj nalazi predivan veliki krevet, ormar, violina te sve potrebno za Kleopatru i Penelopu. Ono što te podsječa na tvoje zatočeništvo su dva prozora sa željeznim rešetkama.

Južno od sobe nalazi se hodnik.

You can see Velika drvena vrata and Violina here.

I beg your pardon?

>s
Hodnik
U hodniku se nalazi mnogo vrata, no tebi su bitna samo ona od Gertrudine sobe koja se nalaze istočno od hodnika. Budući da je mrak u Gertrudinoj sobi, trebala bi uzeti lanternu! Nakon toga, trebaš proći južnim prolazom prema Dnevnoj sobi.

You can see Velika drvena vrata, Prolaz u dnevni and Vrata glavne sobe here.

* * *

>inventory
You are carrying nothing.

Sad je 11:31 pm, još se stigneš spasiti!

>ask penelopa about vrijeme
Ne znam što bih rekla.

Sad je 11:32 pm, još se stigneš spasiti!

>s
(first opening Velika drvena vrata)
Otvorila si vrata svoje sobe.

Hodnik
U hodniku se nalazi mnogo vrata, no tebi su bitna samo ona od Gertrudine sobe koja se nalaze istočno od hodnika. Budući da je mrak u Gertrudinoj sobi, trebala bi uzeti lanternu! Nakon toga, trebaš proći južnim prolazom prema Dnevnoj sobi.

You can see Velika drvena vrata, Prolaz u dnevni, Vrata glavne sobe and Lanterna here.

Sad je 11:33 pm, još se stigneš spasiti!

>take lanterna
Uzela si lanternu. Sad možeš u Gertrudinu sobu.

Taken.

Sad je 11:34 pm, još se stigneš spasiti!

* * *

>e
(first opening Vrata glavne sobe)
Otvorila si vrata glavne sobe
Glavna soba
Glavna soba je Gertrudina soba, najveća soba u dvorcu. U njoj se nalazi kraljevski krevet, njezin omiljeni ljubimac tvor Otto koji je u kavezu, ormar, noćni ormar te komoda. U njoj se negdje također nalazi ključ glavnih vrata dvorca, pronađi ga! Zapadno se nalaze Vrata glavne sobe!

You can see Vrata glavne sobe, Penelopa, Kleopatra, Kavez (in which is Otto), Komoda (closed) and Nocni ormar (closed) here.

Sad je 11:35 pm, još se stigneš spasiti!

>examine komoda
Velika drvena komoda napravljena od hrasta i stakla. Pogledaj je li u njoj negdje ključ.

Sad je 11:36 pm, još se stigneš spasiti!

>open komoda
You open Komoda, revealing Glavni kljuc.

Sad je 11:37 pm, još se stigneš spasiti!

>examine komoda
Velika drvena komoda napravljena od hrasta i stakla. Pogledaj je li u njoj negdje ključ.

In Komoda is Glavni kljuc.

Sad je 11:38 pm, još se stigneš spasiti!

>examine komoda
Vidi, u njoj se nalazi glavni kljuc!

In Komoda is Glavni kljuc.

Sad je 11:39 pm, još se stigneš spasiti!

>take glavni kljuc
Uzela si kljuc za izlazna vrata.

Taken.

Sad je 11:40 pm, još se stigneš spasiti!

>w
Hodnik
U hodniku se nalazi mnogo vrata, no tebi su bitna samo ona od Gertrudine sobe koja se nalaze istočno od hodnika. Budući da je mrak u Gertrudinoj sobi, trebala bi uzeti lanternu! Nakon toga, trebaš proći južnim prolazom prema Dnevnoj sobi.

You can see Vrata glavne sobe, Velika drvena vrata and Prolaz u dnevni here.

Sad je 11:41 pm, još se stigneš spasiti!

>s
(first opening Prolaz u dnevni)

Dnevna soba
Raskošna dnevna soba s velikim kaminom u kojem gori vatra. Na stolu u kutu nalazi se hrana. Mogla bi si uzeti malo za put. Sjeverno se nalazi Prolaz prema hodniku. Zapadno se nalaze izlazna vrata - tvoj spas!

On Stol is Hrana.

You can also see Izlazna vrata, Prolaz u dnevni, Penelopa and Kleopatra here.

Sad je 11:42 pm, još se stigneš spasiti!

>take hrana
Ovo će dobro doći za put!

Sad je 11:43 pm, još se stigneš spasiti!

>eat hrana
Ostavi hranu za put. Trebat će ti!

Sad je 11:44 pm, još se stigneš spasiti!

>unlock izlazna vrata
What do you want to unlock Izlazna vrata with?

>glavni kljuc
You unlock Izlazna vrata.

Sad je 11:45 pm, još se stigneš spasiti!

>w
(first opening Izlazna vrata)
Otvorila si Izlazna vrata.

Dvoriste
Lia je ovdje, veliki njemački ovčar koji čuva dvorac noću. Moram ju pomaziti da me pusti.

You can also see Izlazna vrata, Penelopa and Kleopatra here.

Sad je 11:46 pm, još se stigneš spasiti!

>pomazi Lia
*** Čestitam, uspjela si se spasiti! Odletjela si na Penelopi. ***

Would you like to RESTART, RESTORE a saved game, QUIT or UNDO the last command?

* * *

>examine glavni kljuc
You can't see any such thing.

>examine Glavni kljuc
You can't see any such thing.

>s
(first opening Velika drvena vrata)
Otvorila si vrata svoje sobe.

Hodnik
U hodniku se nalazi mnogo vrata, no tebi su bitna samo ona od Gertrudine sobe koja se nalaze istočno od hodnika. Budući da je mrak u Gertrudinoj sobi, trebala bi uzeti lanternu! Nakon toga, trebaš proći južnim prolazom prema Dnevnoj sobi.

You can see Velika drvena vrata, Prolaz u dnevni, Vrata glavne sobe and Lanterna here.

Sad je 11:30 pm, još se stigneš spasiti!

>take lanterna
Uzela si lanternu. Sad možeš u Gertrudinu sobu.

Taken.

Sad je 11:31 pm, još se stigneš spasiti!

>e
(first opening Vrata glavne sobe)
Otvorila si vrata glavne sobe
Glavna soba
Glavna soba je Gertrudina soba, najveća soba u dvorcu. U njoj se nalazi kraljevski krevet, njezin omiljeni ljubimac tvor Otto koji je u kavezu, ormar, noćni ormar te komoda. U njoj se negdje također nalazi ključ glavnih vrata dvorca, pronađi ga! Zapadno se nalaze Vrata glavne sobe!

You can see Vrata glavne sobe, Penelopa, Kleopatra, Kavez (in which is Otto), Komoda (closed) and Nocni ormar (closed) here.

Sad je 11:32 pm, još se stigneš spasiti!

>examine glavni kljuc
You can't see any such thing.

>open komoda
You open Komoda, revealing Skrinja.

Sad je 11:33 pm, još se stigneš spasiti!

>open skrinja
It seems to be locked.

Sad je 11:34 pm, još se stigneš spasiti!

>examine glavni kljuc
You can't see any such thing.

>unlock skrinja
(with Lanterna)
That doesn't seem to fit the lock.

Sad je 11:35 pm, još se stigneš spasiti!

* * *

>pogledaj Penelopa
Sad je 11:30 pm, još se stigneš spasiti!

>pogledaj Gertruda
You can't see any such thing.

* * *

>s
(first opening Velika drvena vrata)
Otvorila si vrata svoje sobe.

Hodnik
U hodniku se nalazi mnogo vrata, no tebi su bitna samo ona od Gertrudine sobe koja se nalaze negdje u hodniku. Budući da je mrak u Gertrudinoj sobi, trebala bi uzeti lanternu! Nakon toga, trebaš proći južnim prolazom prema Dnevnoj sobi.

You can see Velika drvena vrata, Prolaz u dnevni, Vrata glavne sobe and Lanterna (in which is Svijeca) here.

Sad je 11:31 pm, još se stigneš spasiti!

>procitaj vrata
I didn't understand that sentence.

>velika drvena vrata
That's not a verb I recognise.

>procitaj natpis
What do you want to procitaj natpis?

>procitaj vrata glavne sobe
I didn't understand that sentence.

>procitaj natpis vrata glavne sobe
Glavna soba - Gertruda.
Sad je 11:32 pm, još se stigneš spasiti!

>open vrata glavne sobe
Otvorila si vrata glavne sobe
You open Vrata glavne sobe.

Sad je 11:33 pm, još se stigneš spasiti!

>e
U glavnoj sobi je premračno! Uzmi lanternu.

Sad je 11:34 pm, još se stigneš spasiti!

>take lanterna
Moraš upaliti svijeću u lanterni.

Sad je 11:35 pm, još se stigneš spasiti!

>e
U glavnoj sobi je premračno! Uzmi lanternu.

Sad je 11:36 pm, još se stigneš spasiti!

>inventory
You are carrying:
  Lanterna
    Svijeca

Sad je 11:37 pm, još se stigneš spasiti!

>lit lanterna
That's not a verb I recognise.

>zapali svijecu
You can't see any such thing.

>zapali svijeću lanterna
You can't see any such thing.

>zapali svijeca
Zapalila si svijeću
Sad je 11:38 pm, još se stigneš spasiti!